Symbol	KEGG_PATHWAYS_FILTERED
XPC	Nucleotide excision repair
LSM7	RNA degradation
LSM7	Spliceosome
IMP4	Ribosome biogenesis in eukaryotes
PPCDC	Pantothenate and CoA biosynthesis
ACADSB	Valine, leucine and isoleucine degradation
ACADSB	Fatty acid metabolism
RPP40	RNA transport
RPP40	Ribosome biogenesis in eukaryotes
RPL26L1	Ribosome
NXF3	mRNA surveillance pathway
NXF3	RNA transport
NXF3	Ribosome biogenesis in eukaryotes
PNLIPRP1	Glycerolipid metabolism
RSL24D1P11	Ribosome
LOC391767	Basal transcription factors
LOC391766	Basal transcription factors
LOC391764	Basal transcription factors
LOC729724	Basal transcription factors
LOC729706	Basal transcription factors
LOC729711	Basal transcription factors
LOC402207	Basal transcription factors
LOC100288018	Basal transcription factors
LOC100288562	Ribosome biogenesis in eukaryotes
HMGB1P40	Base excision repair
CYP21A1P	Steroid hormone biosynthesis
DOLPP1	N-Glycan biosynthesis
INPP5J	Inositol phosphate metabolism
FUK	Fructose and mannose metabolism
FUK	Amino sugar and nucleotide sugar metabolism
CYP4A22	Retinol metabolism
CYP4A22	Arachidonic acid metabolism
CYP4A22	Fatty acid metabolism
CRYL1	Pentose and glucuronate interconversions
NT5C1A	Nicotinate and nicotinamide metabolism
NT5C1A	Purine metabolism
NT5C1A	Pyrimidine metabolism
PDXP	Vitamin B6 metabolism
MAN2A2	N-Glycan biosynthesis
HGSNAT	Glycosaminoglycan degradation
HGSNAT	Lysosome
DGKZ	Glycerophospholipid metabolism
DGKZ	Glycerolipid metabolism
PGP	Glyoxylate and dicarboxylate metabolism
FBXO6	Protein processing in endoplasmic reticulum
ZMAT2	Spliceosome
NANP	Amino sugar and nucleotide sugar metabolism
LSM5	RNA degradation
LSM5	Spliceosome
RPP21	RNA transport
ELAC1	RNA transport
PAOX	Peroxisome
ACPT	Riboflavin metabolism
DHX8	Spliceosome
LFNG	Other types of O-glycan biosynthesis
PSAPL1	Lysosome
ALG11	N-Glycan biosynthesis
CYP26C1	Retinol metabolism
TJP3	Tight junction
ADCY1	Purine metabolism
ADCY1	Oocyte meiosis
ADCY1	Gap junction
POLR3D	RNA polymerase
POLR3D	Purine metabolism
POLR3D	Pyrimidine metabolism
CTSO	Lysosome
OPLAH	Glutathione metabolism
POFUT1	Other types of O-glycan biosynthesis
QPRT	Nicotinate and nicotinamide metabolism
PGAM2	Glycolysis / Gluconeogenesis
GEMIN8	RNA transport
GPD1L	Glycerophospholipid metabolism
PIGB	Glycosylphosphatidylinositol(GPI)-anchor biosynthesis
CYP2U1	Arachidonic acid metabolism
DGKI	Glycerophospholipid metabolism
DGKI	Glycerolipid metabolism
STT3B	N-Glycan biosynthesis
STT3B	Protein processing in endoplasmic reticulum
PTDSS1	Glycerophospholipid metabolism
PGAP1	Glycosylphosphatidylinositol(GPI)-anchor biosynthesis
CHERP	Spliceosome
AP4E1	Lysosome
SHC2	Focal adhesion
NIT2	Alanine, aspartate and glutamate metabolism
DECR2	Peroxisome
MBOAT2	Glycerophospholipid metabolism
MBOAT2	Glycerolipid metabolism
DYNC1LI2	Phagosome
WDR75	Ribosome biogenesis in eukaryotes
MPHOSPH6	RNA degradation
NAPRT1	Nicotinate and nicotinamide metabolism
REXO1L1	Ribosome biogenesis in eukaryotes
SENP2	RNA transport
ITGAD	Regulation of actin cytoskeleton
POLR3E	RNA polymerase
POLR3E	Purine metabolism
POLR3E	Pyrimidine metabolism
PSD4	Endocytosis
B3GNT7	Glycosaminoglycan biosynthesis - keratan sulfate
WBSCR17	Mucin type O-Glycan biosynthesis
UTP18	Ribosome biogenesis in eukaryotes
PCF11	mRNA surveillance pathway
CLDN19	Tight junction
DEGS2	Sphingolipid metabolism
SH3GLB2	Endocytosis
AMDHD1	Histidine metabolism
CTU2	Sulfur relay system
MAN1C1	N-Glycan biosynthesis
MAN1C1	Protein processing in endoplasmic reticulum
MPV17L	Peroxisome
SEC61G	Phagosome
SEC61G	Protein processing in endoplasmic reticulum
SEC61G	Protein export
VAMP5	SNARE interactions in vesicular transport
SSH3	Regulation of actin cytoskeleton
TXNL4A	Spliceosome
PFKFB4	Fructose and mannose metabolism
MARCH6	Protein processing in endoplasmic reticulum
DERL2	Protein processing in endoplasmic reticulum
TAF3	Basal transcription factors
SSH2	Regulation of actin cytoskeleton
RPL22L1	Ribosome
SRP68	Protein export
POP4	RNA transport
POP4	Ribosome biogenesis in eukaryotes
ENOPH1	Cysteine and methionine metabolism
RRP7A	Ribosome biogenesis in eukaryotes
ENGASE	Other glycan degradation
ENTPD3	Purine metabolism
ENTPD3	Pyrimidine metabolism
NMD3	RNA transport
NMD3	Ribosome biogenesis in eukaryotes
GNPNAT1	Amino sugar and nucleotide sugar metabolism
TREH	Starch and sucrose metabolism
STX10	SNARE interactions in vesicular transport
ITGA8	Regulation of actin cytoskeleton
ITGA8	Focal adhesion
IDI2	Terpenoid backbone biosynthesis
LLGL2	Tight junction
CHST14	Glycosaminoglycan biosynthesis - chondroitin sulfate
PSMD6	Proteasome
SPCS2	Protein export
ARPC5L	Regulation of actin cytoskeleton
PYCRL	Arginine and proline metabolism
MBOAT1	Glycerophospholipid metabolism
MBOAT1	Glycerolipid metabolism
GMDS	Fructose and mannose metabolism
GMDS	Amino sugar and nucleotide sugar metabolism
PGLS	Pentose phosphate pathway
FOLR4	Endocytosis
UPP2	Drug metabolism - other enzymes
UPP2	Pyrimidine metabolism
NUP188	RNA transport
TRMT11	Histidine metabolism
TRMT11	Tyrosine metabolism
PRPF38B	Spliceosome
TARSL2	Aminoacyl-tRNA biosynthesis
PXMP2	Peroxisome
PSME4	Proteasome
PFAS	Purine metabolism
DCP1B	RNA degradation
B3GALT6	Glycosaminoglycan biosynthesis - chondroitin sulfate
B3GALT6	Glycosaminoglycan biosynthesis - heparan sulfate
B3GALTL	Other types of O-glycan biosynthesis
RQCD1	RNA degradation
SPDYC	Oocyte meiosis
WIBG	mRNA surveillance pathway
WIBG	RNA transport
COL6A6	Focal adhesion
POFUT2	Other types of O-glycan biosynthesis
LMAN1L	Protein processing in endoplasmic reticulum
MGRN1	Ubiquitin mediated proteolysis
PNLIPRP2	Glycerolipid metabolism
PARN	RNA degradation
PIGL	Glycosylphosphatidylinositol(GPI)-anchor biosynthesis
TKTL2	Pentose phosphate pathway
ACOT12	Pyruvate metabolism
COLEC12	Phagosome
AHCYL2	Cysteine and methionine metabolism
RPP30	RNA transport
RPP30	Ribosome biogenesis in eukaryotes
GALNT9	Mucin type O-Glycan biosynthesis
GXYLT2	Other types of O-glycan biosynthesis
STX1B	SNARE interactions in vesicular transport
ALG9	N-Glycan biosynthesis
PDE6B	Purine metabolism
TSTA3	Fructose and mannose metabolism
TSTA3	Amino sugar and nucleotide sugar metabolism
UBE2Q1	Ubiquitin mediated proteolysis
NEU2	Other glycan degradation
NEU2	Sphingolipid metabolism
XAB2	Spliceosome
PPP2R3B	mRNA surveillance pathway
RPIA	Pentose phosphate pathway
PANK3	Pantothenate and CoA biosynthesis
RFNG	Other types of O-glycan biosynthesis
ADSSL1	Alanine, aspartate and glutamate metabolism
ADSSL1	Purine metabolism
ACYP1	Pyruvate metabolism
POLR3F	RNA polymerase
POLR3F	Purine metabolism
POLR3F	Pyrimidine metabolism
ELOVL2	Biosynthesis of unsaturated fatty acids
P4HA3	Arginine and proline metabolism
GXYLT1	Other types of O-glycan biosynthesis
NDUFB11	Oxidative phosphorylation
DET1	Ubiquitin mediated proteolysis
LPCAT4	Glycerophospholipid metabolism
LPCAT4	Ether lipid metabolism
FBXW8	Ubiquitin mediated proteolysis
ALG5	N-Glycan biosynthesis
PGAM4	Glycolysis / Gluconeogenesis
PEX11G	Peroxisome
DPM3	N-Glycan biosynthesis
PIGP	Glycosylphosphatidylinositol(GPI)-anchor biosynthesis
TNN	Focal adhesion
SYF2	Spliceosome
PRPF40B	Spliceosome
USP39	Spliceosome
CHSY3	Glycosaminoglycan biosynthesis - chondroitin sulfate
SHISA5	p53 signaling pathway
PIGH	Glycosylphosphatidylinositol(GPI)-anchor biosynthesis
CMPK2	Pyrimidine metabolism
ALG8	N-Glycan biosynthesis
IQSEC2	Endocytosis
CRNKL1	Spliceosome
AASDHPPT	Pantothenate and CoA biosynthesis
BTG3	RNA degradation
ADSS	Alanine, aspartate and glutamate metabolism
ADSS	Purine metabolism
SSR2	Protein processing in endoplasmic reticulum
ACOX2	Primary bile acid biosynthesis
ACOX2	Peroxisome
PAPD7	RNA degradation
LAPTM5	Lysosome
FPGT	Fructose and mannose metabolism
FPGT	Amino sugar and nucleotide sugar metabolism
APC2	Regulation of actin cytoskeleton
AGPAT3	Glycerophospholipid metabolism
AGPAT3	Glycerolipid metabolism
IQGAP3	Regulation of actin cytoskeleton
INMT	Tryptophan metabolism
INMT	Selenocompound metabolism
ATG3	Regulation of autophagy
PFKFB3	Fructose and mannose metabolism
ENPP6	Ether lipid metabolism
ARPC4	Regulation of actin cytoskeleton
ENPP7	Sphingolipid metabolism
MAN2B2	Other glycan degradation
STEAP3	p53 signaling pathway
POM121L2	RNA transport
SEC62	Protein processing in endoplasmic reticulum
SEC62	Protein export
PRPS2	Purine metabolism
PRPS2	Pentose phosphate pathway
YOD1	Protein processing in endoplasmic reticulum
SPDYA	Oocyte meiosis
ETNK1	Glycerophospholipid metabolism
SGPP2	Sphingolipid metabolism
EHD2	Endocytosis
TAF8	Basal transcription factors
ST6GALNAC3	Glycosphingolipid biosynthesis - ganglio series
NAGPA	Lysosome
ALG1	N-Glycan biosynthesis
AGPAT9	Glycerophospholipid metabolism
AGPAT9	Glycerolipid metabolism
LDHD	Pyruvate metabolism
PTPLA	Biosynthesis of unsaturated fatty acids
EHD4	Endocytosis
SESN2	p53 signaling pathway
NDST3	Glycosaminoglycan biosynthesis - heparan sulfate
FARP2	Adherens junction
FBXO43	Oocyte meiosis
NUDT19	Peroxisome
STX19	SNARE interactions in vesicular transport
ST8SIA5	Glycosphingolipid biosynthesis - ganglio series
SEC11A	Protein export
GALNTL5	Mucin type O-Glycan biosynthesis
FUCA2	Other glycan degradation
UQCR10	Oxidative phosphorylation
RBM25	Spliceosome
BNIP1	SNARE interactions in vesicular transport
UBQLN3	Protein processing in endoplasmic reticulum
ACY3	Histidine metabolism
ACY3	Alanine, aspartate and glutamate metabolism
METTL6	Histidine metabolism
METTL6	Tyrosine metabolism
NDUFA4L2	Oxidative phosphorylation
ELOVL5	Biosynthesis of unsaturated fatty acids
CCBL2	Tryptophan metabolism
CCBL2	Selenocompound metabolism
SEPHS2	Selenocompound metabolism
GEMIN6	RNA transport
UQCRC2	Oxidative phosphorylation
HAGHL	Pyruvate metabolism
FMO4	Drug metabolism - cytochrome P450
RPP25	RNA transport
RPP25	Ribosome biogenesis in eukaryotes
NGLY1	Protein processing in endoplasmic reticulum
DNAJC6	Endocytosis
IDI1	Terpenoid backbone biosynthesis
GEMIN7	RNA transport
TMSB4Y	Regulation of actin cytoskeleton
TTC37	RNA degradation
GBGT1	Glycosphingolipid biosynthesis - globo series
MCEE	Glyoxylate and dicarboxylate metabolism
MCEE	Propanoate metabolism
MCEE	Valine, leucine and isoleucine degradation
LPCAT1	Glycerophospholipid metabolism
LPCAT1	Ether lipid metabolism
PPT2	Lysosome
PPT2	Fatty acid elongation
ADCY4	Purine metabolism
ADCY4	Oocyte meiosis
ADCY4	Gap junction
PSTK	Selenocompound metabolism
PSTK	Aminoacyl-tRNA biosynthesis
DYNC1LI1	Phagosome
POP5	RNA transport
POP5	Ribosome biogenesis in eukaryotes
DERL3	Protein processing in endoplasmic reticulum
HS3ST3A1	Glycosaminoglycan biosynthesis - heparan sulfate
ALG12	N-Glycan biosynthesis
OLAH	Fatty acid biosynthesis
ENTPD6	Purine metabolism
ENTPD6	Pyrimidine metabolism
DNASE2B	Lysosome
COX8A	Oxidative phosphorylation
ACOT7	Biosynthesis of unsaturated fatty acids
LPGAT1	Glycerophospholipid metabolism
NXT1	mRNA surveillance pathway
NXT1	RNA transport
NXT1	Ribosome biogenesis in eukaryotes
CTPS2	Pyrimidine metabolism
UBE4B	Ubiquitin mediated proteolysis
UBE4B	Protein processing in endoplasmic reticulum
ST6GALNAC1	Mucin type O-Glycan biosynthesis
PSD2	Endocytosis
NDST4	Glycosaminoglycan biosynthesis - heparan sulfate
PISD	Glycerophospholipid metabolism
NXF2B	mRNA surveillance pathway
NXF2B	RNA transport
NXF2B	Ribosome biogenesis in eukaryotes
UTP6	Ribosome biogenesis in eukaryotes
BTG4	RNA degradation
PSD3	Endocytosis
ARPC1A	Regulation of actin cytoskeleton
TM7SF2	Steroid biosynthesis
BUD31	Spliceosome
THOC7	RNA transport
GALNT13	Mucin type O-Glycan biosynthesis
COX6B2	Oxidative phosphorylation
ALG10	N-Glycan biosynthesis
DERA	Pentose phosphate pathway
ATG4A	Regulation of autophagy
PPCS	Pantothenate and CoA biosynthesis
CHPF2	Glycosaminoglycan biosynthesis - chondroitin sulfate
PRUNE	Purine metabolism
DSE	Glycosaminoglycan biosynthesis - chondroitin sulfate
PAN2	RNA degradation
HSD3B7	Primary bile acid biosynthesis
ATXN3L	Protein processing in endoplasmic reticulum
AMY1B	Starch and sucrose metabolism
MTHFD2L	One carbon pool by folate
ISY1	Spliceosome
AGK	Glycerolipid metabolism
PSD	Endocytosis
SNRNP27	Spliceosome
STAG1	Cell cycle
CYB5R2	Amino sugar and nucleotide sugar metabolism
B3GALT1	Glycosphingolipid biosynthesis - lacto and neolacto series
PIK3R5	Regulation of actin cytoskeleton
PIK3R5	Focal adhesion
PIK3R5	Apoptosis
HYAL4	Glycosaminoglycan degradation
NOL6	Ribosome biogenesis in eukaryotes
CSGALNACT2	Glycosaminoglycan biosynthesis - chondroitin sulfate
SAP18	mRNA surveillance pathway
SAP18	RNA transport
ADO	Taurine and hypotaurine metabolism
UST	Glycosaminoglycan biosynthesis - chondroitin sulfate
PVRL4	Adherens junction
NT5M	Nicotinate and nicotinamide metabolism
NT5M	Purine metabolism
NT5M	Pyrimidine metabolism
AASS	Lysine degradation
AASS	Lysine biosynthesis
OGDHL	Tryptophan metabolism
OGDHL	Lysine degradation
OGDHL	Citrate cycle (TCA cycle)
GNPTG	Lysosome
MGAT4C	N-Glycan biosynthesis
SESN3	p53 signaling pathway
NDST2	Glycosaminoglycan biosynthesis - heparan sulfate
WBP11	Spliceosome
FOLR3	Endocytosis
FGF11	Regulation of actin cytoskeleton
MRPL13	Ribosome
MYH3	Tight junction
ADPGK	Glycolysis / Gluconeogenesis
HS6ST1	Glycosaminoglycan biosynthesis - heparan sulfate
GBA3	Starch and sucrose metabolism
GBA3	Cyanoamino acid metabolism
ATG4D	Regulation of autophagy
MYH15	Tight junction
CA7	Nitrogen metabolism
RBKS	Pentose phosphate pathway
EIF4E1B	RNA transport
GTF2H5	Basal transcription factors
GTF2H5	Nucleotide excision repair
MPST	Sulfur relay system
MPST	Cysteine and methionine metabolism
NANS	Amino sugar and nucleotide sugar metabolism
UXS1	Starch and sucrose metabolism
UXS1	Amino sugar and nucleotide sugar metabolism
DEGS1	Sphingolipid metabolism
COX6B1	Oxidative phosphorylation
MPDZ	Tight junction
PPP2R3C	mRNA surveillance pathway
PAPOLG	mRNA surveillance pathway
GTF2H2C	Basal transcription factors
GTF2H2C	Nucleotide excision repair
SETD2	Lysine degradation
ZFYVE20	Endocytosis
B3GALNT1	Glycosphingolipid biosynthesis - globo series
SUV420H1	Lysine degradation
B3GNT1	Glycosaminoglycan biosynthesis - keratan sulfate
B3GNT1	Glycosphingolipid biosynthesis - lacto and neolacto series
B4GALT4	Glycosaminoglycan biosynthesis - keratan sulfate
B4GALT4	Glycosphingolipid biosynthesis - lacto and neolacto series
SMG5	mRNA surveillance pathway
NEIL3	Base excision repair
BDH2	Synthesis and degradation of ketone bodies
BDH2	Butanoate metabolism
PNPLA4	Retinol metabolism
CYB5R1	Amino sugar and nucleotide sugar metabolism
SNAP47	SNARE interactions in vesicular transport
PIGO	Glycosylphosphatidylinositol(GPI)-anchor biosynthesis
PEX26	Peroxisome
FUT5	Glycosphingolipid biosynthesis - lacto and neolacto series
PIGG	Glycosylphosphatidylinositol(GPI)-anchor biosynthesis
GCNT4	Mucin type O-Glycan biosynthesis
CNOT10	RNA degradation
PFN3	Regulation of actin cytoskeleton
CNOT4	RNA degradation
XYLB	Pentose and glucuronate interconversions
EDEM1	Protein processing in endoplasmic reticulum
PIGV	Glycosylphosphatidylinositol(GPI)-anchor biosynthesis
UQCR11	Oxidative phosphorylation
PFKFB1	Fructose and mannose metabolism
PYCR2	Arginine and proline metabolism
LOC729020	Pentose and glucuronate interconversions
LOC729020	Pentose phosphate pathway
ST6GALNAC6	Glycosphingolipid biosynthesis - ganglio series
ATP6V1E2	Phagosome
ATP6V1E2	Oxidative phosphorylation
POLR2J3	RNA polymerase
POLR2J3	Purine metabolism
POLR2J3	Pyrimidine metabolism
NDUFB1	Oxidative phosphorylation
COX8C	Oxidative phosphorylation
SSR1	Protein processing in endoplasmic reticulum
NDUFB2	Oxidative phosphorylation
DHRS4L2	Retinol metabolism
STAG3	Oocyte meiosis
PFN4	Regulation of actin cytoskeleton
PRPF38A	Spliceosome
HAL	Histidine metabolism
HAL	Nitrogen metabolism
PRPS1L1	Purine metabolism
PRPS1L1	Pentose phosphate pathway
PTPLB	Biosynthesis of unsaturated fatty acids
MAN1A2	N-Glycan biosynthesis
MAN1A2	Protein processing in endoplasmic reticulum
ST6GAL2	N-Glycan biosynthesis
ST6GAL2	Other types of O-glycan biosynthesis
HS3ST3B1	Glycosaminoglycan biosynthesis - heparan sulfate
SHC4	Focal adhesion
DDX23	Spliceosome
PTDSS2	Glycerophospholipid metabolism
DHDH	Pentose and glucuronate interconversions
DHDH	Metabolism of xenobiotics by cytochrome P450
AGXT2	Alanine, aspartate and glutamate metabolism
AGXT2	Glycine, serine and threonine metabolism
FGF10	Regulation of actin cytoskeleton
THTPA	Thiamine metabolism
ACOT2	Biosynthesis of unsaturated fatty acids
ALG14	N-Glycan biosynthesis
GALNT5	Mucin type O-Glycan biosynthesis
SULT1A4	Sulfur metabolism
UPRT	Pyrimidine metabolism
CNOT3	RNA degradation
MTMR1	Fructose and mannose metabolism
PEX11A	Peroxisome
VTI1A	SNARE interactions in vesicular transport
PAPOLB	mRNA surveillance pathway
SNUPN	RNA transport
UTP14C	Ribosome biogenesis in eukaryotes
MYH2	Tight junction
LYPLA1	Glycerophospholipid metabolism
MPHOSPH10	Ribosome biogenesis in eukaryotes
ALG13	N-Glycan biosynthesis
SEC22B	SNARE interactions in vesicular transport
SEC22B	Phagosome
PAIP1	RNA transport
PNPO	Vitamin B6 metabolism
UQCRHL	Oxidative phosphorylation
CHST12	Glycosaminoglycan biosynthesis - chondroitin sulfate
CHST12	Sulfur metabolism
STT3A	N-Glycan biosynthesis
STT3A	Protein processing in endoplasmic reticulum
APIP	Cysteine and methionine metabolism
FGD3	Regulation of actin cytoskeleton
MTMR6	Fructose and mannose metabolism
CTU1	Sulfur relay system
LIPT2	Lipoic acid metabolism
CNOT2	RNA degradation
GK2	Glycerolipid metabolism
REXO1	Ribosome biogenesis in eukaryotes
MTFMT	One carbon pool by folate
MTFMT	Aminoacyl-tRNA biosynthesis
CDC25A	Cell cycle
SQLE	Steroid biosynthesis
SEC11C	Protein export
SPCS1	Protein export
PDSS2	Terpenoid backbone biosynthesis
NUDT5	Purine metabolism
MAGI3	Tight junction
CSAD	Taurine and hypotaurine metabolism
COX6A2	Oxidative phosphorylation
MFSD8	Lysosome
NDUFV3	Oxidative phosphorylation
AP3M1	Lysosome
GPX6	Glutathione metabolism
GPX6	Arachidonic acid metabolism
C12orf5	Fructose and mannose metabolism
MAGOHB	mRNA surveillance pathway
MAGOHB	RNA transport
MAGOHB	Spliceosome
CYP4F11	Arachidonic acid metabolism
SLU7	Spliceosome
NME5	Purine metabolism
NME5	Pyrimidine metabolism
ACER2	Sphingolipid metabolism
DGKE	Glycerophospholipid metabolism
DGKE	Glycerolipid metabolism
MTMR7	Fructose and mannose metabolism
B3GALT2	Glycosphingolipid biosynthesis - lacto and neolacto series
DCTD	Pyrimidine metabolism
UPP1	Drug metabolism - other enzymes
UPP1	Pyrimidine metabolism
B3GALT5	Glycosphingolipid biosynthesis - lacto and neolacto series
B3GALT5	Glycosphingolipid biosynthesis - globo series
GGA1	Lysosome
RPL36AL	Ribosome
RNF41	Endocytosis
TAF4B	Basal transcription factors
SULT2B1	Steroid hormone biosynthesis
SULT2B1	Sulfur metabolism
TRAF2	Apoptosis
TRAF2	Protein processing in endoplasmic reticulum
VNN2	Pantothenate and CoA biosynthesis
B4GALT6	Sphingolipid metabolism
CPT1C	Fatty acid metabolism
SF3B5	Spliceosome
BCMO1	Retinol metabolism
IPMK	Inositol phosphate metabolism
CHRM4	Regulation of actin cytoskeleton
CUL5	Ubiquitin mediated proteolysis
INPPL1	Inositol phosphate metabolism
GGA2	Lysosome
MGAT3	N-Glycan biosynthesis
TAF12	Basal transcription factors
TFDP1	Cell cycle
AMY1C	Starch and sucrose metabolism
CCNG1	p53 signaling pathway
PIGS	Glycosylphosphatidylinositol(GPI)-anchor biosynthesis
AMPD3	Purine metabolism
CTSC	Lysosome
RETSAT	Retinol metabolism
CA13	Nitrogen metabolism
AGXT	Alanine, aspartate and glutamate metabolism
AGXT	Glycine, serine and threonine metabolism
AGXT	Peroxisome
NUP93	RNA transport
STX8	SNARE interactions in vesicular transport
ITGA11	Regulation of actin cytoskeleton
ITGA11	Focal adhesion
ACOT4	Biosynthesis of unsaturated fatty acids
SRD5A1	Steroid hormone biosynthesis
ANAPC11	Ubiquitin mediated proteolysis
ANAPC11	Cell cycle
ANAPC11	Oocyte meiosis
CYP27B1	Steroid biosynthesis
HAO2	Glyoxylate and dicarboxylate metabolism
HAO2	Peroxisome
METTL2B	Histidine metabolism
METTL2B	Tyrosine metabolism
CFL2	Regulation of actin cytoskeleton
DDO	Alanine, aspartate and glutamate metabolism
DDO	Peroxisome
DYNC1H1	Phagosome
EDC3	RNA degradation
CHST6	Glycosaminoglycan biosynthesis - keratan sulfate
SNRPB	Spliceosome
IFNA4	Regulation of autophagy
ALDOC	Fructose and mannose metabolism
ALDOC	Glycolysis / Gluconeogenesis
ALDOC	Pentose phosphate pathway
GANAB	N-Glycan biosynthesis
GANAB	Protein processing in endoplasmic reticulum
COQ6	Ubiquinone and other terpenoid-quinone biosynthesis
ACADL	Fatty acid metabolism
UPF2	mRNA surveillance pathway
UPF2	RNA transport
NME7	Purine metabolism
NME7	Pyrimidine metabolism
AP4M1	Lysosome
LAPTM4B	Lysosome
DCT	Tyrosine metabolism
PPP2R5D	mRNA surveillance pathway
PPP2R5D	Oocyte meiosis
HCLS1	Tight junction
HLA-DOA	Phagosome
COL3A1	Focal adhesion
MGAT5	N-Glycan biosynthesis
NDUFB6	Oxidative phosphorylation
CPT1A	Fatty acid metabolism
MARS	Selenocompound metabolism
MARS	Aminoacyl-tRNA biosynthesis
GTF2E2	Basal transcription factors
CHST15	Glycosaminoglycan biosynthesis - chondroitin sulfate
MGST2	Glutathione metabolism
MGST2	Metabolism of xenobiotics by cytochrome P450
MGST2	Drug metabolism - cytochrome P450
TRAM1	Protein processing in endoplasmic reticulum
GADD45G	Cell cycle
GADD45G	p53 signaling pathway
CLDN9	Tight junction
PEX12	Peroxisome
UROD	Porphyrin and chlorophyll metabolism
STX5	SNARE interactions in vesicular transport
DCXR	Pentose and glucuronate interconversions
NOX3	Phagosome
ALOX12B	Arachidonic acid metabolism
FGF7	Regulation of actin cytoskeleton
DPM1	N-Glycan biosynthesis
TRMU	Sulfur relay system
GPAM	Glycerophospholipid metabolism
GPAM	Glycerolipid metabolism
HIBCH	Propanoate metabolism
HIBCH	Valine, leucine and isoleucine degradation
HIBCH	beta-Alanine metabolism
ATP5J2	Oxidative phosphorylation
LAMP1	Phagosome
LAMP1	Lysosome
THOC2	RNA transport
THOC2	Spliceosome
INPP5A	Inositol phosphate metabolism
UGGT1	Protein processing in endoplasmic reticulum
UPF3B	mRNA surveillance pathway
UPF3B	RNA transport
CYP39A1	Primary bile acid biosynthesis
SCD5	Biosynthesis of unsaturated fatty acids
ARPC3	Regulation of actin cytoskeleton
OXCT2	Valine, leucine and isoleucine degradation
OXCT2	Synthesis and degradation of ketone bodies
OXCT2	Butanoate metabolism
SPHK2	Sphingolipid metabolism
PPAT	Alanine, aspartate and glutamate metabolism
PPAT	Purine metabolism
TXNRD3	Selenocompound metabolism
TXNRD3	Pyrimidine metabolism
ALDH1A2	Retinol metabolism
IDH3G	Citrate cycle (TCA cycle)
PGS1	Glycerophospholipid metabolism
NUP88	RNA transport
GSTM5	Glutathione metabolism
GSTM5	Metabolism of xenobiotics by cytochrome P450
GSTM5	Drug metabolism - cytochrome P450
SCP2	Primary bile acid biosynthesis
SCP2	Peroxisome
LDLRAP1	Endocytosis
FGF17	Regulation of actin cytoskeleton
STX2	SNARE interactions in vesicular transport
TOB1	RNA degradation
NAT1	Caffeine metabolism
NAT1	Drug metabolism - other enzymes
ARHGEF6	Regulation of actin cytoskeleton
RILP	Phagosome
COX4I2	Oxidative phosphorylation
SSR4	Protein processing in endoplasmic reticulum
TAF4	Basal transcription factors
COX7B2	Oxidative phosphorylation
EIF4B	RNA transport
GPAT2	Glycerophospholipid metabolism
GPAT2	Glycerolipid metabolism
PARD6G	Endocytosis
PARD6G	Tight junction
PRPS1	Purine metabolism
PRPS1	Pentose phosphate pathway
CTSA	Lysosome
HS3ST5	Glycosaminoglycan biosynthesis - heparan sulfate
GLCE	Glycosaminoglycan biosynthesis - heparan sulfate
PNLIP	Glycerolipid metabolism
NUDT9	Purine metabolism
LAP3	Glutathione metabolism
LAP3	Arginine and proline metabolism
DGUOK	Purine metabolism
LIAS	Lipoic acid metabolism
MAGI2	Tight junction
CYCS	p53 signaling pathway
CYCS	Apoptosis
PNLIPRP3	Glycerolipid metabolism
ATP5F1	Oxidative phosphorylation
RENBP	Amino sugar and nucleotide sugar metabolism
PDE7B	Purine metabolism
LRAT	Retinol metabolism
BBOX1	Lysine degradation
CKMT2	Arginine and proline metabolism
CA5B	Nitrogen metabolism
PGM2L1	Starch and sucrose metabolism
IFNA7	Regulation of autophagy
NUP155	RNA transport
EIF4G3	RNA transport
ATP6V0E2	Phagosome
ATP6V0E2	Oxidative phosphorylation
ADCY2	Purine metabolism
ADCY2	Oocyte meiosis
ADCY2	Gap junction
COL4A4	Focal adhesion
HAO1	Glyoxylate and dicarboxylate metabolism
HAO1	Peroxisome
CLDN8	Tight junction
ANAPC13	Ubiquitin mediated proteolysis
ANAPC13	Cell cycle
ANAPC13	Oocyte meiosis
A4GALT	Glycosphingolipid biosynthesis - globo series
SHC1	Focal adhesion
MGAT4B	N-Glycan biosynthesis
MYH13	Tight junction
PLCD1	Inositol phosphate metabolism
PDE1B	Purine metabolism
PHF5A	Spliceosome
TXNDC12	Glutathione metabolism
INPP5K	Inositol phosphate metabolism
UNG	Base excision repair
RHOBTB1	Ubiquitin mediated proteolysis
CLP1	mRNA surveillance pathway
EIF3J	RNA transport
HS6ST2	Glycosaminoglycan biosynthesis - heparan sulfate
ATP6V1C1	Phagosome
ATP6V1C1	Oxidative phosphorylation
HSD3B1	Steroid hormone biosynthesis
CAV3	Endocytosis
CAV3	Focal adhesion
SF3B3	Spliceosome
SF3B1	Spliceosome
GNAI1	Tight junction
GNAI1	Gap junction
PIGN	Glycosylphosphatidylinositol(GPI)-anchor biosynthesis
GADD45A	Cell cycle
GADD45A	p53 signaling pathway
NCF1	Phagosome
ITGA1	Regulation of actin cytoskeleton
ITGA1	Focal adhesion
MLLT4	Adherens junction
MLLT4	Tight junction
PSME1	Proteasome
PTS	Folate biosynthesis
EXTL2	Glycosaminoglycan biosynthesis - heparan sulfate
EFTUD1	Ribosome biogenesis in eukaryotes
LAMB4	Focal adhesion
ASAH2	Sphingolipid metabolism
NUP210	RNA transport
LAMA3	Focal adhesion
TCEB2	Ubiquitin mediated proteolysis
DFFB	Apoptosis
HLA-DMA	Phagosome
MGLL	Glycerolipid metabolism
TNFRSF10D	Apoptosis
ACAD8	Valine, leucine and isoleucine degradation
DGKQ	Glycerophospholipid metabolism
DGKQ	Glycerolipid metabolism
AGPS	Ether lipid metabolism
AGPS	Peroxisome
CA3	Nitrogen metabolism
SUOX	Sulfur metabolism
CKMT1A	Arginine and proline metabolism
CTSF	Lysosome
PXMP4	Peroxisome
SPTLC1	Sphingolipid metabolism
PEX19	Peroxisome
PAPOLA	mRNA surveillance pathway
SUCLG1	Propanoate metabolism
SUCLG1	Citrate cycle (TCA cycle)
HEXDC	Other glycan degradation
MGAT2	N-Glycan biosynthesis
PDE7A	Purine metabolism
DOT1L	Lysine degradation
PPM1D	p53 signaling pathway
TRADD	Apoptosis
SVIP	Protein processing in endoplasmic reticulum
AMY2B	Starch and sucrose metabolism
HADHB	Valine, leucine and isoleucine degradation
HADHB	Fatty acid elongation
HADHB	Fatty acid metabolism
COL6A1	Focal adhesion
TPR	RNA transport
CAD	Alanine, aspartate and glutamate metabolism
CAD	Pyrimidine metabolism
GNAS	Gap junction
COASY	Pantothenate and CoA biosynthesis
EPN3	Endocytosis
MAN2B1	Other glycan degradation
MAN2B1	Lysosome
TXNRD2	Selenocompound metabolism
TXNRD2	Pyrimidine metabolism
PAFAH2	Ether lipid metabolism
MDH2	Glyoxylate and dicarboxylate metabolism
MDH2	Pyruvate metabolism
MDH2	Citrate cycle (TCA cycle)
FGF6	Regulation of actin cytoskeleton
GM2A	Lysosome
COL5A3	Focal adhesion
PDE10A	Purine metabolism
NAPSA	Lysosome
SF3A2	Spliceosome
F11R	Tight junction
PSAP	Lysosome
ACOT8	Peroxisome
NDUFS6	Oxidative phosphorylation
GSTA3	Glutathione metabolism
GSTA3	Metabolism of xenobiotics by cytochrome P450
GSTA3	Drug metabolism - cytochrome P450
GSTM2	Glutathione metabolism
GSTM2	Metabolism of xenobiotics by cytochrome P450
GSTM2	Drug metabolism - cytochrome P450
ARPC1B	Regulation of actin cytoskeleton
HLA-F	Endocytosis
HLA-F	Phagosome
GALNT1	Mucin type O-Glycan biosynthesis
HSD17B4	Primary bile acid biosynthesis
HSD17B4	Peroxisome
PCCA	Glyoxylate and dicarboxylate metabolism
PCCA	Propanoate metabolism
PCCA	Valine, leucine and isoleucine degradation
EIF1B	RNA transport
HGD	Tyrosine metabolism
CYFIP2	Regulation of actin cytoskeleton
RAD51C	Homologous recombination
PCCB	Glyoxylate and dicarboxylate metabolism
PCCB	Propanoate metabolism
PCCB	Valine, leucine and isoleucine degradation
GNE	Amino sugar and nucleotide sugar metabolism
KLHL9	Ubiquitin mediated proteolysis
UQCRFS1	Oxidative phosphorylation
AGPAT6	Glycerophospholipid metabolism
AGPAT6	Glycerolipid metabolism
MCCC2	Valine, leucine and isoleucine degradation
SDS	Cysteine and methionine metabolism
SDS	Glycine, serine and threonine metabolism
PC	Pyruvate metabolism
PC	Citrate cycle (TCA cycle)
TOB2	RNA degradation
COX6A1	Oxidative phosphorylation
GATM	Glycine, serine and threonine metabolism
GATM	Arginine and proline metabolism
NT5C1B	Nicotinate and nicotinamide metabolism
NT5C1B	Purine metabolism
NT5C1B	Pyrimidine metabolism
NDUFA9	Oxidative phosphorylation
BET1	SNARE interactions in vesicular transport
PTPRF	Adherens junction
NUP205	RNA transport
POMT1	Other types of O-glycan biosynthesis
OAT	Arginine and proline metabolism
CA4	Nitrogen metabolism
NXF2	mRNA surveillance pathway
NXF2	RNA transport
NXF2	Ribosome biogenesis in eukaryotes
HLA-DOB	Phagosome
GCLM	Glutathione metabolism
GTF2A1	Basal transcription factors
ATIC	Purine metabolism
ATIC	One carbon pool by folate
PIAS1	Ubiquitin mediated proteolysis
SIAH1	Ubiquitin mediated proteolysis
SIAH1	p53 signaling pathway
PHAX	RNA transport
ST6GALNAC5	Glycosphingolipid biosynthesis - ganglio series
CHIT1	Amino sugar and nucleotide sugar metabolism
NXF1	mRNA surveillance pathway
NXF1	RNA transport
NXF1	Ribosome biogenesis in eukaryotes
POMT2	Other types of O-glycan biosynthesis
B3GALT4	Glycosphingolipid biosynthesis - ganglio series
ADCY9	Purine metabolism
ADCY9	Oocyte meiosis
ADCY9	Gap junction
NNT	Nicotinate and nicotinamide metabolism
BCKDHB	Valine, leucine and isoleucine degradation
ATP5G3	Oxidative phosphorylation
ERCC4	Nucleotide excision repair
NUP214	RNA transport
NAGLU	Glycosaminoglycan degradation
NAGLU	Lysosome
TDG	Base excision repair
GCH1	Folate biosynthesis
RPP14	RNA transport
STX18	SNARE interactions in vesicular transport
STX18	Phagosome
DFFA	Apoptosis
EIF4E2	RNA transport
HPRT1	Drug metabolism - other enzymes
HPRT1	Purine metabolism
NDUFA4	Oxidative phosphorylation
IQGAP2	Regulation of actin cytoskeleton
SSR3	Protein processing in endoplasmic reticulum
CYC1	Oxidative phosphorylation
FH	Citrate cycle (TCA cycle)
COX7B	Oxidative phosphorylation
CHKA	Glycerophospholipid metabolism
PSMC2	Proteasome
PRKAR1A	Apoptosis
VAMP1	SNARE interactions in vesicular transport
AMOTL1	Tight junction
POLA1	Purine metabolism
POLA1	DNA replication
POLA1	Pyrimidine metabolism
ALLC	Purine metabolism
NUP153	RNA transport
INPP4B	Inositol phosphate metabolism
MIOX	Inositol phosphate metabolism
MIOX	Ascorbate and aldarate metabolism
FBL	Ribosome biogenesis in eukaryotes
HSD17B10	Valine, leucine and isoleucine degradation
PAPSS2	Selenocompound metabolism
PAPSS2	Sulfur metabolism
PAPSS2	Purine metabolism
MAN2C1	Other glycan degradation
HS3ST2	Glycosaminoglycan biosynthesis - heparan sulfate
COX11	Oxidative phosphorylation
SGMS1	Sphingolipid metabolism
CHIA	Amino sugar and nucleotide sugar metabolism
GALNT14	Mucin type O-Glycan biosynthesis
ENTPD8	Purine metabolism
ENTPD8	Pyrimidine metabolism
GLYCTK	Glyoxylate and dicarboxylate metabolism
GLYCTK	Glycerolipid metabolism
GLYCTK	Glycine, serine and threonine metabolism
IMMP1L	Protein export
SUMO4	RNA transport
ITGA7	Regulation of actin cytoskeleton
ITGA7	Focal adhesion
GALNT8	Mucin type O-Glycan biosynthesis
PDE4C	Purine metabolism
AKR1C2	Steroid hormone biosynthesis
AKR1C2	Metabolism of xenobiotics by cytochrome P450
GALNS	Glycosaminoglycan degradation
GALNS	Lysosome
PHOSPHO1	Glycerophospholipid metabolism
DIAPH2	Regulation of actin cytoskeleton
ENTPD2	Purine metabolism
FMO5	Drug metabolism - cytochrome P450
SRP72	Protein export
HIBADH	Valine, leucine and isoleucine degradation
UGT8	Sphingolipid metabolism
PI4K2B	Inositol phosphate metabolism
CEL	Glycerolipid metabolism
CEL	Steroid biosynthesis
ATF4	Protein processing in endoplasmic reticulum
CHST3	Glycosaminoglycan biosynthesis - chondroitin sulfate
GTF2H4	Basal transcription factors
GTF2H4	Nucleotide excision repair
RFT1	N-Glycan biosynthesis
COX15	Porphyrin and chlorophyll metabolism
COX15	Oxidative phosphorylation
USE1	SNARE interactions in vesicular transport
IDUA	Glycosaminoglycan degradation
IDUA	Lysosome
PMM2	Fructose and mannose metabolism
PMM2	Amino sugar and nucleotide sugar metabolism
CSGALNACT1	Glycosaminoglycan biosynthesis - chondroitin sulfate
SEC24B	Protein processing in endoplasmic reticulum
ASAH1	Sphingolipid metabolism
ASAH1	Lysosome
FIGF	Focal adhesion
NUP85	RNA transport
AGL	Starch and sucrose metabolism
GPX7	Glutathione metabolism
GPX7	Arachidonic acid metabolism
EPN2	Endocytosis
PEX2	Peroxisome
IMPA1	Inositol phosphate metabolism
PIGU	Glycosylphosphatidylinositol(GPI)-anchor biosynthesis
SUCLA2	Propanoate metabolism
SUCLA2	Citrate cycle (TCA cycle)
PHOSPHO2	Vitamin B6 metabolism
ATP5J	Oxidative phosphorylation
CPT2	Fatty acid metabolism
FUCA1	Other glycan degradation
FUCA1	Lysosome
ABI2	Regulation of actin cytoskeleton
STAG2	Cell cycle
HSD17B8	Steroid hormone biosynthesis
C1GALT1C1	Mucin type O-Glycan biosynthesis
MDN1	Ribosome biogenesis in eukaryotes
PARP2	Base excision repair
NOP58	Ribosome biogenesis in eukaryotes
GTF2H2	Basal transcription factors
GTF2H2	Nucleotide excision repair
PCK2	Pyruvate metabolism
PCK2	Glycolysis / Gluconeogenesis
PCK2	Citrate cycle (TCA cycle)
RRM1	Glutathione metabolism
RRM1	Purine metabolism
RRM1	Pyrimidine metabolism
NT5C	Nicotinate and nicotinamide metabolism
NT5C	Purine metabolism
NT5C	Pyrimidine metabolism
LAMC3	Focal adhesion
GTSE1	p53 signaling pathway
DAK	Glycerolipid metabolism
SRP9	Protein export
TBPL1	Basal transcription factors
FMO2	Drug metabolism - cytochrome P450
TYR	Riboflavin metabolism
TYR	Tyrosine metabolism
DHRS4	Retinol metabolism
DHRS4	Peroxisome
SOAT1	Steroid biosynthesis
NDUFB10	Oxidative phosphorylation
ARHGEF12	Regulation of actin cytoskeleton
MYH7	Tight junction
NCBP2	mRNA surveillance pathway
NCBP2	RNA transport
NCBP2	Spliceosome
PGM3	Amino sugar and nucleotide sugar metabolism
PLCB4	Inositol phosphate metabolism
PLCB4	Gap junction
MYH4	Tight junction
ALG10B	N-Glycan biosynthesis
DBH	Tyrosine metabolism
NPC1	Lysosome
UBE4A	Ubiquitin mediated proteolysis
FMO1	Drug metabolism - cytochrome P450
HSPBP1	Protein processing in endoplasmic reticulum
PEX16	Peroxisome
TBXAS1	Arachidonic acid metabolism
CNOT1	RNA degradation
CHST10	Other types of O-glycan biosynthesis
DTYMK	Pyrimidine metabolism
ANAPC1	Ubiquitin mediated proteolysis
ANAPC1	Cell cycle
ANAPC1	Oocyte meiosis
RPP38	RNA transport
RPP38	Ribosome biogenesis in eukaryotes
SULT1E1	Steroid hormone biosynthesis
SULT1E1	Sulfur metabolism
CDKN2A	Cell cycle
CDKN2A	p53 signaling pathway
MSN	Regulation of actin cytoskeleton
HEMK1	Histidine metabolism
HEMK1	Tyrosine metabolism
B3GNT5	Glycosphingolipid biosynthesis - lacto and neolacto series
ATP6V1G3	Phagosome
ATP6V1G3	Oxidative phosphorylation
GALT	Amino sugar and nucleotide sugar metabolism
GALT	Galactose metabolism
TYRP1	Tyrosine metabolism
UCK2	Drug metabolism - other enzymes
UCK2	Pyrimidine metabolism
ANAPC7	Ubiquitin mediated proteolysis
ANAPC7	Cell cycle
ANAPC7	Oocyte meiosis
UBE2Q2	Ubiquitin mediated proteolysis
SLC25A17	Peroxisome
COQ5	Ubiquinone and other terpenoid-quinone biosynthesis
ASPA	Histidine metabolism
ASPA	Alanine, aspartate and glutamate metabolism
GALNT10	Mucin type O-Glycan biosynthesis
GNMT	Glycine, serine and threonine metabolism
CD164	Lysosome
YARS2	Aminoacyl-tRNA biosynthesis
PPP2R2D	mRNA surveillance pathway
PPP2R2D	Tight junction
ACOT1	Biosynthesis of unsaturated fatty acids
DGKA	Glycerophospholipid metabolism
DGKA	Glycerolipid metabolism
HLA-DRB4	Phagosome
POLR2J2	RNA polymerase
POLR2J2	Purine metabolism
POLR2J2	Pyrimidine metabolism
TALDO1	Pentose phosphate pathway
SGOL1	Oocyte meiosis
NPL	Amino sugar and nucleotide sugar metabolism
LMAN2	Protein processing in endoplasmic reticulum
GEMIN4	RNA transport
EPB41L2	Tight junction
NDUFA6	Oxidative phosphorylation
INPP5B	Inositol phosphate metabolism
ACER1	Sphingolipid metabolism
PVRL3	Adherens junction
TRIM37	Ubiquitin mediated proteolysis
CRKL	Regulation of actin cytoskeleton
CRKL	Focal adhesion
CERK	Sphingolipid metabolism
PARP4	Base excision repair
CEPT1	Glycerophospholipid metabolism
CEPT1	Ether lipid metabolism
PEX13	Peroxisome
APEX2	Base excision repair
SMURF1	Endocytosis
SMURF1	Ubiquitin mediated proteolysis
CHRM1	Regulation of actin cytoskeleton
HAAO	Tryptophan metabolism
CASC3	mRNA surveillance pathway
CASC3	RNA transport
PRODH2	Arginine and proline metabolism
ALPI	Folate biosynthesis
ZFYVE16	Endocytosis
NDUFA8	Oxidative phosphorylation
CBLC	Endocytosis
CBLC	Ubiquitin mediated proteolysis
CCND3	Cell cycle
CCND3	p53 signaling pathway
CCND3	Focal adhesion
NDUFAB1	Oxidative phosphorylation
NDUFB5	Oxidative phosphorylation
RCL1	Ribosome biogenesis in eukaryotes
GALE	Amino sugar and nucleotide sugar metabolism
GALE	Galactose metabolism
PFN2	Regulation of actin cytoskeleton
EPT1	Glycerophospholipid metabolism
EPT1	Ether lipid metabolism
SLC27A5	Primary bile acid biosynthesis
HEATR1	Ribosome biogenesis in eukaryotes
IDS	Glycosaminoglycan degradation
IDS	Lysosome
NUP160	RNA transport
EIF3C	RNA transport
OXCT1	Valine, leucine and isoleucine degradation
OXCT1	Synthesis and degradation of ketone bodies
OXCT1	Butanoate metabolism
PXN	Regulation of actin cytoskeleton
PXN	Focal adhesion
EDEM2	Protein processing in endoplasmic reticulum
IARS	Aminoacyl-tRNA biosynthesis
IARS	Valine, leucine and isoleucine biosynthesis
PIGC	Glycosylphosphatidylinositol(GPI)-anchor biosynthesis
ELOVL6	Biosynthesis of unsaturated fatty acids
TLN1	Focal adhesion
DHODH	Pyrimidine metabolism
STX12	Phagosome
AP3B2	Lysosome
DGKB	Glycerophospholipid metabolism
DGKB	Glycerolipid metabolism
CES1	Drug metabolism - other enzymes
MCAT	Fatty acid biosynthesis
UQCRB	Oxidative phosphorylation
XYLT2	Glycosaminoglycan biosynthesis - chondroitin sulfate
XYLT2	Glycosaminoglycan biosynthesis - heparan sulfate
DPM2	N-Glycan biosynthesis
DPM2	Glycosylphosphatidylinositol(GPI)-anchor biosynthesis
HS2ST1	Glycosaminoglycan biosynthesis - heparan sulfate
CDO1	Cysteine and methionine metabolism
CDO1	Taurine and hypotaurine metabolism
PIPOX	Lysine degradation
PIPOX	Glycine, serine and threonine metabolism
PIPOX	Peroxisome
DGKG	Glycerophospholipid metabolism
DGKG	Glycerolipid metabolism
CWC15	Spliceosome
LAPTM4A	Lysosome
GART	Purine metabolism
GART	One carbon pool by folate
PDE6C	Purine metabolism
SMAD6	Endocytosis
KPNB1	RNA transport
DHCR24	Steroid biosynthesis
AK7	Purine metabolism
LCLAT1	Glycerophospholipid metabolism
LCLAT1	Glycerolipid metabolism
EDEM3	Protein processing in endoplasmic reticulum
GNA11	Gap junction
DDB1	Ubiquitin mediated proteolysis
DDB1	Nucleotide excision repair
TAF9B	Basal transcription factors
SPR	Folate biosynthesis
POLR3GL	RNA polymerase
POLR3GL	Purine metabolism
POLR3GL	Pyrimidine metabolism
PARVG	Focal adhesion
MGAM	Starch and sucrose metabolism
MGAM	Galactose metabolism
GALNT7	Mucin type O-Glycan biosynthesis
PNPLA7	Glycerophospholipid metabolism
ITGA9	Regulation of actin cytoskeleton
ITGA9	Focal adhesion
MAT2B	Cysteine and methionine metabolism
GSPT1	mRNA surveillance pathway
ATP6V0E1	Phagosome
ATP6V0E1	Oxidative phosphorylation
ALG6	N-Glycan biosynthesis
NTPCR	Purine metabolism
NTPCR	Thiamine metabolism
RNASEH2C	DNA replication
DPAGT1	N-Glycan biosynthesis
PIGZ	Glycosylphosphatidylinositol(GPI)-anchor biosynthesis
PMM1	Fructose and mannose metabolism
PMM1	Amino sugar and nucleotide sugar metabolism
DOLK	N-Glycan biosynthesis
STAM2	Endocytosis
ARPC5	Regulation of actin cytoskeleton
POLR2L	RNA polymerase
POLR2L	Purine metabolism
POLR2L	Pyrimidine metabolism
COL6A3	Focal adhesion
LAMB3	Focal adhesion
EMG1	Ribosome biogenesis in eukaryotes
PSMD3	Proteasome
CES5A	Drug metabolism - other enzymes
XPOT	RNA transport
LALBA	Galactose metabolism
MBTPS1	Protein processing in endoplasmic reticulum
GOSR2	SNARE interactions in vesicular transport
PARVB	Focal adhesion
GPT2	Alanine, aspartate and glutamate metabolism
PNN	mRNA surveillance pathway
PNN	RNA transport
SEL1L	Protein processing in endoplasmic reticulum
CA5A	Nitrogen metabolism
HMBS	Porphyrin and chlorophyll metabolism
TCEB1	Ubiquitin mediated proteolysis
OS9	Protein processing in endoplasmic reticulum
M6PR	Phagosome
M6PR	Lysosome
NUP107	RNA transport
ALDH18A1	Arginine and proline metabolism
MECR	Fatty acid elongation
AP2A2	Endocytosis
CPOX	Porphyrin and chlorophyll metabolism
GCDH	Tryptophan metabolism
GCDH	Lysine degradation
GCDH	Fatty acid metabolism
AMY2A	Starch and sucrose metabolism
MBD4	Base excision repair
CROT	Peroxisome
LSS	Steroid biosynthesis
UBA6	Ubiquitin mediated proteolysis
RBL1	Cell cycle
CYP8B1	Primary bile acid biosynthesis
B3GNT2	Glycosaminoglycan biosynthesis - keratan sulfate
B3GNT2	Glycosphingolipid biosynthesis - lacto and neolacto series
ATP6V1G2	Phagosome
ATP6V1G2	Oxidative phosphorylation
RUFY1	Endocytosis
ARSG	Lysosome
SART1	Spliceosome
ALPP	Folate biosynthesis
TAF7	Basal transcription factors
EXTL3	Glycosaminoglycan biosynthesis - heparan sulfate
CTSG	Lysosome
OXSM	Fatty acid biosynthesis
AP1G1	Lysosome
RPS27L	Ribosome
OGDH	Tryptophan metabolism
OGDH	Lysine degradation
OGDH	Citrate cycle (TCA cycle)
NADSYN1	Nicotinate and nicotinamide metabolism
SETD8	Lysine degradation
MTHFD1L	One carbon pool by folate
GNAI3	Tight junction
GNAI3	Gap junction
CTSW	Lysosome
AGMAT	Arginine and proline metabolism
MBTPS2	Protein processing in endoplasmic reticulum
AMPD2	Purine metabolism
GMPR2	Purine metabolism
BIRC3	Ubiquitin mediated proteolysis
BIRC3	Focal adhesion
BIRC3	Apoptosis
CGN	Tight junction
SRP19	Protein export
HCCS	Porphyrin and chlorophyll metabolism
MTHFD2	One carbon pool by folate
P4HA1	Arginine and proline metabolism
HNRNPC	Spliceosome
CES2	Drug metabolism - other enzymes
LCMT2	Histidine metabolism
LCMT2	Tyrosine metabolism
TRNT1	RNA transport
GMPPA	Fructose and mannose metabolism
GMPPA	Amino sugar and nucleotide sugar metabolism
MDH1	Glyoxylate and dicarboxylate metabolism
MDH1	Pyruvate metabolism
MDH1	Citrate cycle (TCA cycle)
COL4A6	Focal adhesion
ST6GAL1	N-Glycan biosynthesis
ST6GAL1	Other types of O-glycan biosynthesis
IL3RA	Apoptosis
CLNS1A	RNA transport
AADAT	Tryptophan metabolism
AADAT	Lysine degradation
AADAT	Lysine biosynthesis
PIGW	Glycosylphosphatidylinositol(GPI)-anchor biosynthesis
RPL10L	Ribosome
CDC45	Cell cycle
EPHX2	Arachidonic acid metabolism
EPHX2	Peroxisome
GPX2	Glutathione metabolism
GPX2	Arachidonic acid metabolism
PIGF	Glycosylphosphatidylinositol(GPI)-anchor biosynthesis
AGPAT4	Glycerophospholipid metabolism
AGPAT4	Glycerolipid metabolism
AGPAT1	Glycerophospholipid metabolism
AGPAT1	Glycerolipid metabolism
PPT1	Lysosome
PPT1	Fatty acid elongation
CA12	Nitrogen metabolism
NOP10	Ribosome biogenesis in eukaryotes
ATP5I	Oxidative phosphorylation
GCNT3	Mucin type O-Glycan biosynthesis
CRLS1	Glycerophospholipid metabolism
CHST7	Glycosaminoglycan biosynthesis - chondroitin sulfate
THBS4	Phagosome
THBS4	Focal adhesion
CLDN18	Tight junction
CLDN4	Tight junction
HTR2B	Gap junction
PTPRM	Adherens junction
MUT	Glyoxylate and dicarboxylate metabolism
MUT	Propanoate metabolism
MUT	Valine, leucine and isoleucine degradation
ABO	Glycosphingolipid biosynthesis - lacto and neolacto series
LIPG	Glycerolipid metabolism
ATP5L	Oxidative phosphorylation
CYP2S1	Metabolism of xenobiotics by cytochrome P450
BRCA1	Ubiquitin mediated proteolysis
LTC4S	Arachidonic acid metabolism
CS	Glyoxylate and dicarboxylate metabolism
CS	Citrate cycle (TCA cycle)
MYH9	Regulation of actin cytoskeleton
MYH9	Tight junction
HNRNPK	Spliceosome
CBL	Endocytosis
CBL	Ubiquitin mediated proteolysis
UBQLN1	Protein processing in endoplasmic reticulum
CA14	Nitrogen metabolism
SAT2	Arginine and proline metabolism
CHST13	Glycosaminoglycan biosynthesis - chondroitin sulfate
CHST13	Sulfur metabolism
GTF2E1	Basal transcription factors
UGGT2	Protein processing in endoplasmic reticulum
GMPR	Purine metabolism
HS3ST1	Glycosaminoglycan biosynthesis - heparan sulfate
TCF7L1	Adherens junction
AMT	Glycine, serine and threonine metabolism
AMT	One carbon pool by folate
AMT	Nitrogen metabolism
CTSZ	Lysosome
SDHA	Oxidative phosphorylation
SDHA	Citrate cycle (TCA cycle)
SEC61B	Phagosome
SEC61B	Protein processing in endoplasmic reticulum
SEC61B	Protein export
MRI1	Cysteine and methionine metabolism
CDA	Drug metabolism - other enzymes
CDA	Pyrimidine metabolism
CPT1B	Fatty acid metabolism
AMY1A	Starch and sucrose metabolism
WHSC1L1	Lysine degradation
ADRB3	Endocytosis
LPCAT3	Glycerophospholipid metabolism
ATF6	Protein processing in endoplasmic reticulum
HACL1	Peroxisome
CPSF1	mRNA surveillance pathway
SGMS2	Sphingolipid metabolism
NXT2	mRNA surveillance pathway
NXT2	RNA transport
NXT2	Ribosome biogenesis in eukaryotes
ANAPC2	Ubiquitin mediated proteolysis
ANAPC2	Cell cycle
ANAPC2	Oocyte meiosis
RAB11FIP3	Endocytosis
ATP6V1C2	Phagosome
ATP6V1C2	Oxidative phosphorylation
NNMT	Nicotinate and nicotinamide metabolism
GALNTL6	Mucin type O-Glycan biosynthesis
JUN	Focal adhesion
FLNC	Focal adhesion
EIF4G2	RNA transport
LAMA2	Focal adhesion
GOSR1	SNARE interactions in vesicular transport
NDUFA10	Oxidative phosphorylation
PNP	Nicotinate and nicotinamide metabolism
PNP	Purine metabolism
PNP	Pyrimidine metabolism
BAG2	Protein processing in endoplasmic reticulum
SEPHS1	Selenocompound metabolism
UQCRQ	Oxidative phosphorylation
FBP2	Fructose and mannose metabolism
FBP2	Glycolysis / Gluconeogenesis
FBP2	Pentose phosphate pathway
PHYH	Peroxisome
IDO1	Tryptophan metabolism
ZCCHC7	RNA degradation
TK1	Drug metabolism - other enzymes
TK1	Pyrimidine metabolism
CHPF	Glycosaminoglycan biosynthesis - chondroitin sulfate
MGAT5B	N-Glycan biosynthesis
MGAT5B	Other types of O-glycan biosynthesis
ATP4B	Oxidative phosphorylation
GTF2H3	Basal transcription factors
GTF2H3	Nucleotide excision repair
CYP27A1	Primary bile acid biosynthesis
COMP	Phagosome
COMP	Focal adhesion
PDE6D	Purine metabolism
ACP6	Riboflavin metabolism
POLR3C	RNA polymerase
POLR3C	Purine metabolism
POLR3C	Pyrimidine metabolism
ACACA	Propanoate metabolism
ACACA	Pyruvate metabolism
ACACA	Fatty acid biosynthesis
CSTF3	mRNA surveillance pathway
B3GNT4	Glycosphingolipid biosynthesis - lacto and neolacto series
ATR	Cell cycle
ATR	p53 signaling pathway
PDGFC	Regulation of actin cytoskeleton
PDGFC	Focal adhesion
PDGFC	Gap junction
GALNT6	Mucin type O-Glycan biosynthesis
LPAR1	Gap junction
UBOX5	Ubiquitin mediated proteolysis
SCIN	Regulation of actin cytoskeleton
GSTA2	Glutathione metabolism
GSTA2	Metabolism of xenobiotics by cytochrome P450
GSTA2	Drug metabolism - cytochrome P450
SCARB1	Phagosome
CLDN22	Tight junction
BCAS2	Spliceosome
CMAS	Amino sugar and nucleotide sugar metabolism
PFN1	Regulation of actin cytoskeleton
ARPC2	Regulation of actin cytoskeleton
NSDHL	Steroid biosynthesis
DERL1	Protein processing in endoplasmic reticulum
NCF4	Phagosome
CA6	Nitrogen metabolism
CDIPT	Inositol phosphate metabolism
CDIPT	Glycerophospholipid metabolism
CFL1	Regulation of actin cytoskeleton
PSME2	Proteasome
ITGA2	Regulation of actin cytoskeleton
ITGA2	Phagosome
ITGA2	Focal adhesion
RNASEH2A	DNA replication
ALDH1L2	One carbon pool by folate
POLR3G	RNA polymerase
POLR3G	Purine metabolism
POLR3G	Pyrimidine metabolism
UBQLNL	Protein processing in endoplasmic reticulum
BTG2	RNA degradation
ACYP2	Pyruvate metabolism
ATG4C	Regulation of autophagy
PRPF18	Spliceosome
VAV3	Regulation of actin cytoskeleton
VAV3	Focal adhesion
SNW1	Spliceosome
THBS2	Phagosome
THBS2	Focal adhesion
PRPF8	Spliceosome
NMNAT1	Nicotinate and nicotinamide metabolism
ME1	Pyruvate metabolism
XRCC3	Homologous recombination
FBP1	Fructose and mannose metabolism
FBP1	Glycolysis / Gluconeogenesis
FBP1	Pentose phosphate pathway
NUP54	RNA transport
SLC11A2	Lysosome
EBP	Steroid biosynthesis
PDE6H	Purine metabolism
ASH1L	Lysine degradation
ASH1L	Tight junction
TNFRSF10C	Apoptosis
EXOC4	Tight junction
ECH1	Peroxisome
SORBS1	Adherens junction
CNOT8	RNA degradation
IFNA13	Regulation of autophagy
BAD	Focal adhesion
BAD	Apoptosis
FDPS	Terpenoid backbone biosynthesis
B3GNT3	Glycosphingolipid biosynthesis - lacto and neolacto series
UROS	Porphyrin and chlorophyll metabolism
PIK3R1	Regulation of actin cytoskeleton
PIK3R1	Focal adhesion
PIK3R1	Apoptosis
FADS1	Biosynthesis of unsaturated fatty acids
NUPL1	RNA transport
COQ3	Ubiquinone and other terpenoid-quinone biosynthesis
ITGB7	Regulation of actin cytoskeleton
ITGB7	Focal adhesion
DGKD	Glycerophospholipid metabolism
DGKD	Glycerolipid metabolism
PERP	p53 signaling pathway
PIAS3	Ubiquitin mediated proteolysis
PTPRJ	Adherens junction
GALK1	Amino sugar and nucleotide sugar metabolism
GALK1	Galactose metabolism
MUS81	Homologous recombination
NMNAT3	Nicotinate and nicotinamide metabolism
ENDOG	Apoptosis
ADCY6	Purine metabolism
ADCY6	Oocyte meiosis
ADCY6	Gap junction
PDXK	Vitamin B6 metabolism
CYB5R3	Amino sugar and nucleotide sugar metabolism
GTF2A2	Basal transcription factors
CNOT7	RNA degradation
GAPDHS	Glycolysis / Gluconeogenesis
REXO2	Ribosome biogenesis in eukaryotes
SDHD	Oxidative phosphorylation
SDHD	Citrate cycle (TCA cycle)
PLOD3	Lysine degradation
PLOD3	Other types of O-glycan biosynthesis
SMNDC1	Spliceosome
PTPN6	Adherens junction
ALAD	Porphyrin and chlorophyll metabolism
CANX	Phagosome
CANX	Protein processing in endoplasmic reticulum
TIAM1	Regulation of actin cytoskeleton
CLN3	Lysosome
PATL1	RNA degradation
GPD1	Glycerophospholipid metabolism
NOX1	Phagosome
CYBA	Phagosome
TST	Sulfur relay system
TST	Cysteine and methionine metabolism
ADK	Purine metabolism
POLR2K	RNA polymerase
POLR2K	Purine metabolism
POLR2K	Pyrimidine metabolism
BLVRB	Porphyrin and chlorophyll metabolism
BLVRB	Riboflavin metabolism
PIGM	Glycosylphosphatidylinositol(GPI)-anchor biosynthesis
RAB11FIP4	Endocytosis
ATP6AP1	Phagosome
ATP6AP1	Lysosome
ATP6AP1	Oxidative phosphorylation
TIAM2	Regulation of actin cytoskeleton
GNPDA1	Amino sugar and nucleotide sugar metabolism
THBS3	Phagosome
THBS3	Focal adhesion
ST6GALNAC4	Glycosphingolipid biosynthesis - ganglio series
CUL3	Ubiquitin mediated proteolysis
PPA2	Oxidative phosphorylation
CLDN10	Tight junction
ALG3	N-Glycan biosynthesis
NPC2	Lysosome
POLR2G	RNA polymerase
POLR2G	Purine metabolism
POLR2G	Pyrimidine metabolism
CLDN16	Tight junction
ACIN1	mRNA surveillance pathway
ACIN1	RNA transport
ACIN1	Spliceosome
COX7A2L	Oxidative phosphorylation
POLR2I	RNA polymerase
POLR2I	Purine metabolism
POLR2I	Pyrimidine metabolism
ERLEC1	Protein processing in endoplasmic reticulum
GUCY1B3	Purine metabolism
GUCY1B3	Gap junction
UCK1	Drug metabolism - other enzymes
UCK1	Pyrimidine metabolism
POM121C	RNA transport
TAF13	Basal transcription factors
TPP1	Lysosome
GLDC	Glycine, serine and threonine metabolism
NDUFA12	Oxidative phosphorylation
POP7	RNA transport
POP7	Ribosome biogenesis in eukaryotes
EIF3A	RNA transport
IMPA2	Inositol phosphate metabolism
CCNA1	Cell cycle
JAM2	Tight junction
NT5E	Nicotinate and nicotinamide metabolism
NT5E	Purine metabolism
NT5E	Pyrimidine metabolism
NDUFA5	Oxidative phosphorylation
NDUFA7	Oxidative phosphorylation
ECI1	Fatty acid metabolism
VARS	Aminoacyl-tRNA biosynthesis
VARS	Valine, leucine and isoleucine biosynthesis
CYFIP1	Regulation of actin cytoskeleton
RAB11FIP5	Endocytosis
PIK3R3	Regulation of actin cytoskeleton
PIK3R3	Focal adhesion
PIK3R3	Apoptosis
HTR2C	Gap junction
ALG2	N-Glycan biosynthesis
CTSH	Lysosome
ATP6V1G1	Phagosome
ATP6V1G1	Oxidative phosphorylation
ARSA	Sphingolipid metabolism
ARSA	Lysosome
ALAS1	Porphyrin and chlorophyll metabolism
ALAS1	Glycine, serine and threonine metabolism
SEC24C	Protein processing in endoplasmic reticulum
GALC	Sphingolipid metabolism
GALC	Lysosome
NAT10	Ribosome biogenesis in eukaryotes
AUH	Valine, leucine and isoleucine degradation
IQSEC1	Endocytosis
NADK	Nicotinate and nicotinamide metabolism
IFNA21	Regulation of autophagy
ATP6V0C	Phagosome
ATP6V0C	Lysosome
ATP6V0C	Oxidative phosphorylation
BCAP31	Protein processing in endoplasmic reticulum
PARD6B	Endocytosis
PARD6B	Tight junction
INS	Regulation of actin cytoskeleton
INS	Regulation of autophagy
INS	Oocyte meiosis
TPMT	Drug metabolism - other enzymes
CKAP4	Protein processing in endoplasmic reticulum
CRYAB	Protein processing in endoplasmic reticulum
FTMT	Porphyrin and chlorophyll metabolism
CA9	Nitrogen metabolism
HMGCR	Terpenoid backbone biosynthesis
ATG7	Regulation of autophagy
ITPA	Drug metabolism - other enzymes
ITPA	Purine metabolism
ITPA	Pyrimidine metabolism
ERO1LB	Protein processing in endoplasmic reticulum
PSME3	Proteasome
NDUFV2	Oxidative phosphorylation
RAB11FIP1	Endocytosis
PDE5A	Purine metabolism
UGCG	Sphingolipid metabolism
ERCC3	Basal transcription factors
ERCC3	Nucleotide excision repair
ARG2	Arginine and proline metabolism
GNAQ	Gap junction
ACO1	Glyoxylate and dicarboxylate metabolism
ACO1	Citrate cycle (TCA cycle)
SRSF2	Spliceosome
GAA	Lysosome
GAA	Starch and sucrose metabolism
GAA	Galactose metabolism
OTC	Arginine and proline metabolism
DNMT1	Cysteine and methionine metabolism
PPP2R1A	mRNA surveillance pathway
PPP2R1A	Tight junction
PPP2R1A	Oocyte meiosis
IMPDH1	Drug metabolism - other enzymes
IMPDH1	Purine metabolism
CASP6	Apoptosis
B3GAT1	Glycosaminoglycan biosynthesis - chondroitin sulfate
B3GAT1	Glycosaminoglycan biosynthesis - heparan sulfate
FLNA	Focal adhesion
SMPD2	Sphingolipid metabolism
AFMID	Glyoxylate and dicarboxylate metabolism
AFMID	Tryptophan metabolism
VPS37A	Endocytosis
EXOSC2	RNA degradation
IL2RG	Endocytosis
EXOSC6	RNA degradation
ARHGEF4	Regulation of actin cytoskeleton
CHMP5	Endocytosis
VPS28	Endocytosis
MOCS1	Folate biosynthesis
MOCS1	Sulfur relay system
CHMP4A	Endocytosis
EXOSC5	RNA degradation
CHMP7	Endocytosis
STAM	Endocytosis
EXOSC10	RNA degradation
CHMP4B	Endocytosis
CHMP4C	Endocytosis
SNAI2	Adherens junction
CRB3	Tight junction
CYP19A1	Steroid hormone biosynthesis
XBP1	Protein processing in endoplasmic reticulum
CCND2	Cell cycle
CCND2	p53 signaling pathway
CCND2	Focal adhesion
PRMT5	RNA transport
FGF21	Regulation of actin cytoskeleton
CHI3L1	Amino sugar and nucleotide sugar metabolism
STX11	SNARE interactions in vesicular transport
CYP2R1	Steroid biosynthesis
SULT1A1	Sulfur metabolism
VTA1	Endocytosis
AR	Oocyte meiosis
IFNA2	Regulation of autophagy
HGS	Endocytosis
HGS	Phagosome
RCHY1	Ubiquitin mediated proteolysis
RCHY1	p53 signaling pathway
MBL2	Phagosome
XRCC6	Non-homologous end-joining
CLDN1	Tight junction
SHMT1	Glycine, serine and threonine metabolism
SHMT1	One carbon pool by folate
SHMT1	Cyanoamino acid metabolism
POLB	Base excision repair
VPS36	Endocytosis
AP2M1	Endocytosis
GJA1	Gap junction
LAMA5	Focal adhesion
SULT1A2	Sulfur metabolism
EXOSC3	RNA degradation
DRD1	Gap junction
SMAD7	Endocytosis
IGF2R	Lysosome
XRCC4	Non-homologous end-joining
VPS25	Endocytosis
SPTAN1	Tight junction
CAT	Tryptophan metabolism
CAT	Peroxisome
PTPN1	Adherens junction
MAP3K1	Ubiquitin mediated proteolysis
ALPL	Folate biosynthesis
VPS37D	Endocytosis
LEF1	Adherens junction
HYAL2	Glycosaminoglycan degradation
LIG3	Base excision repair
ATXN3	Protein processing in endoplasmic reticulum
URM1	Sulfur relay system
PDE6G	Purine metabolism
SETD7	Lysine degradation
MTAP	Cysteine and methionine metabolism
CYP7A1	Steroid hormone biosynthesis
CYP7A1	Primary bile acid biosynthesis
CHMP3	Endocytosis
PIK3R2	Regulation of actin cytoskeleton
PIK3R2	Focal adhesion
PIK3R2	Apoptosis
VPS37C	Endocytosis
CRYAA	Protein processing in endoplasmic reticulum
EXOSC1	RNA degradation
TNFRSF10A	Apoptosis
GBA	Other glycan degradation
GBA	Sphingolipid metabolism
GBA	Lysosome
CHMP2A	Endocytosis
VPS37B	Endocytosis
TSC2	p53 signaling pathway
WASF2	Regulation of actin cytoskeleton
WASF2	Adherens junction
CHMP6	Endocytosis
VHL	Ubiquitin mediated proteolysis
EPB41L3	Tight junction
CP	Porphyrin and chlorophyll metabolism
EXT1	Glycosaminoglycan biosynthesis - heparan sulfate
TNFRSF10B	p53 signaling pathway
TNFRSF10B	Apoptosis
GADD45B	Cell cycle
GADD45B	p53 signaling pathway
CSNK2B	Adherens junction
CSNK2B	Tight junction
CSNK2B	Ribosome biogenesis in eukaryotes
STX6	SNARE interactions in vesicular transport
XRN1	RNA degradation
XRN1	Ribosome biogenesis in eukaryotes
G6PD	Glutathione metabolism
G6PD	Pentose phosphate pathway
CHST11	Glycosaminoglycan biosynthesis - chondroitin sulfate
CHST11	Sulfur metabolism
DNMT3A	Cysteine and methionine metabolism
HYAL1	Glycosaminoglycan degradation
HYAL1	Lysosome
SH3GL1	Endocytosis
SPHK1	Sphingolipid metabolism
CASP7	Apoptosis
CYP51A1	Steroid biosynthesis
INPP5E	Inositol phosphate metabolism
FCGR2A	Phagosome
FCGR2B	Phagosome
GNA12	Regulation of actin cytoskeleton
GMPPB	Fructose and mannose metabolism
GMPPB	Amino sugar and nucleotide sugar metabolism
GPT	Alanine, aspartate and glutamate metabolism
TGFB2	Endocytosis
TGFB2	Cell cycle
PQBP1	Spliceosome
PFKFB2	Fructose and mannose metabolism
ALAS2	Porphyrin and chlorophyll metabolism
ALAS2	Glycine, serine and threonine metabolism
SRD5A3	Steroid hormone biosynthesis
NUP98	RNA transport
COL5A2	Focal adhesion
NAMPT	Nicotinate and nicotinamide metabolism
SGPL1	Sphingolipid metabolism
TPI1	Inositol phosphate metabolism
TPI1	Fructose and mannose metabolism
TPI1	Glycolysis / Gluconeogenesis
CYP4F2	Arachidonic acid metabolism
TH	Tyrosine metabolism
DHDDS	Terpenoid backbone biosynthesis
H6PD	Pentose phosphate pathway
SNAI1	Adherens junction
CYP11A1	Steroid hormone biosynthesis
AKR1C3	Steroid hormone biosynthesis
AKR1C3	Metabolism of xenobiotics by cytochrome P450
AKR1C3	Arachidonic acid metabolism
MYH8	Tight junction
ADSL	Alanine, aspartate and glutamate metabolism
ADSL	Purine metabolism
SMAD2	Endocytosis
SMAD2	Adherens junction
SMAD2	Cell cycle
TLN2	Focal adhesion
CLDN6	Tight junction
ACP5	Lysosome
ACP5	Riboflavin metabolism
SCD	Biosynthesis of unsaturated fatty acids
EIF4EBP1	RNA transport
MTHFD1	One carbon pool by folate
ITGB4	Regulation of actin cytoskeleton
ITGB4	Focal adhesion
COL5A1	Focal adhesion
ARRB1	Endocytosis
ACHE	Glycerophospholipid metabolism
SPTLC2	Sphingolipid metabolism
RPS14	Ribosome
RPS3A	Ribosome
RPS21	Ribosome
RPS20	Ribosome
RPS5	Ribosome
RPS17	Ribosome
RPS13	Ribosome
RPS7	Ribosome
RPS9	Ribosome
RPS12	Ribosome
RPS19	Ribosome
RPS18	Ribosome
RPS11	Ribosome
RPL37	Ribosome
RPS27	Ribosome
RPL38	Ribosome
RPL6	Ribosome
RPL41	Ribosome
RPLP2	Ribosome
RPL28	Ribosome
RPL36A	Ribosome
RPS24	Ribosome
RPL31	Ribosome
RPL32	Ribosome
RPL11	Ribosome
RPL23A	Ribosome
RPL30	Ribosome
RPS26	Ribosome
RPS28	Ribosome
RPL26	Ribosome
RPL27A	Ribosome
RPL12	Ribosome
RPL10	Ribosome
RPLP1	Ribosome
RPS29	Ribosome
RPL18	Ribosome
RPS23	Ribosome
RPL34	Ribosome
RPL39	Ribosome
RPL35	Ribosome
RPL29	Ribosome
RPL22	Ribosome
RPL36	Ribosome
RPL13A	Ribosome
RPL35A	Ribosome
RPS25	Ribosome
SUV420H2	Lysine degradation
DDOST	N-Glycan biosynthesis
DDOST	Protein processing in endoplasmic reticulum
GALNT2	Mucin type O-Glycan biosynthesis
LIPF	Glycerolipid metabolism
MGAT1	N-Glycan biosynthesis
PSMF1	Proteasome
RABEP1	Endocytosis
TKTL1	Pentose phosphate pathway
TCERG1	Spliceosome
ATG5	Regulation of autophagy
NDUFB9	Oxidative phosphorylation
E2F2	Cell cycle
FECH	Porphyrin and chlorophyll metabolism
CLDN11	Tight junction
SRP14	Protein export
SNAP25	SNARE interactions in vesicular transport
CHKB	Glycerophospholipid metabolism
GRM1	Gap junction
BST1	Nicotinate and nicotinamide metabolism
VTI1B	SNARE interactions in vesicular transport
TKT	Pentose phosphate pathway
ODC1	Glutathione metabolism
ODC1	Arginine and proline metabolism
FCAR	Phagosome
WHSC1	Lysine degradation
PTGS1	Arachidonic acid metabolism
PAFAH1B3	Ether lipid metabolism
BDKRB2	Regulation of actin cytoskeleton
GALK2	Amino sugar and nucleotide sugar metabolism
GALK2	Galactose metabolism
LIG4	Non-homologous end-joining
HSD17B3	Steroid hormone biosynthesis
LMAN1	Protein processing in endoplasmic reticulum
EIF2B2	RNA transport
COL2A1	Focal adhesion
ITGA6	Regulation of actin cytoskeleton
ITGA6	Focal adhesion
SH3GL2	Endocytosis
ME3	Pyruvate metabolism
STX7	SNARE interactions in vesicular transport
STX7	Phagosome
HMOX2	Porphyrin and chlorophyll metabolism
HLA-DRB3	Phagosome
VAMP7	SNARE interactions in vesicular transport
ST3GAL5	Glycosphingolipid biosynthesis - ganglio series
PVRL2	Adherens junction
DIAPH1	Regulation of actin cytoskeleton
DIAPH1	Focal adhesion
AP3M2	Lysosome
MGST1	Glutathione metabolism
MGST1	Metabolism of xenobiotics by cytochrome P450
MGST1	Drug metabolism - cytochrome P450
RGN	Ascorbate and aldarate metabolism
RGN	Pentose phosphate pathway
ST3GAL3	Glycosaminoglycan biosynthesis - keratan sulfate
ST3GAL3	Glycosphingolipid biosynthesis - lacto and neolacto series
ST3GAL3	Other types of O-glycan biosynthesis
STAMBP	Endocytosis
MAN2A1	N-Glycan biosynthesis
GTF2F1	Basal transcription factors
PPP2R5A	mRNA surveillance pathway
PPP2R5A	Oocyte meiosis
ITGA3	Regulation of actin cytoskeleton
ITGA3	Focal adhesion
DGAT1	Retinol metabolism
DGAT1	Glycerolipid metabolism
RNMT	mRNA surveillance pathway
CLN5	Lysosome
THOC1	RNA transport
THOC1	Spliceosome
EXTL1	Glycosaminoglycan biosynthesis - heparan sulfate
TAF1	Basal transcription factors
SYMPK	mRNA surveillance pathway
SYMPK	Tight junction
MTHFS	One carbon pool by folate
ALPPL2	Folate biosynthesis
ALOX15B	Arachidonic acid metabolism
PIGK	Glycosylphosphatidylinositol(GPI)-anchor biosynthesis
NEU3	Other glycan degradation
NEU3	Sphingolipid metabolism
COX7C	Oxidative phosphorylation
ITGB5	Regulation of actin cytoskeleton
ITGB5	Phagosome
ITGB5	Focal adhesion
PDE9A	Purine metabolism
PMVK	Peroxisome
PMVK	Terpenoid backbone biosynthesis
ACO2	Glyoxylate and dicarboxylate metabolism
ACO2	Citrate cycle (TCA cycle)
CKMT1B	Arginine and proline metabolism
DNTT	Non-homologous end-joining
LMO7	Adherens junction
NOP56	Ribosome biogenesis in eukaryotes
GALNT3	Mucin type O-Glycan biosynthesis
COL6A2	Focal adhesion
CTNS	Lysosome
FGF12	Regulation of actin cytoskeleton
SSBP1	Mismatch repair
SSBP1	Homologous recombination
SSBP1	DNA replication
SRRM1	mRNA surveillance pathway
SRRM1	RNA transport
NDUFB7	Oxidative phosphorylation
PRKAR2A	Apoptosis
WASF1	Regulation of actin cytoskeleton
WASF1	Adherens junction
PVRL1	Adherens junction
GSS	Glutathione metabolism
ADCY5	Purine metabolism
ADCY5	Oocyte meiosis
ADCY5	Gap junction
CLDN5	Tight junction
GCNT1	Mucin type O-Glycan biosynthesis
HDC	Histidine metabolism
COX5B	Oxidative phosphorylation
LAMP2	Phagosome
LAMP2	Lysosome
PDHX	Pyruvate metabolism
PDHX	Glycolysis / Gluconeogenesis
PDHX	Citrate cycle (TCA cycle)
BID	p53 signaling pathway
BID	Apoptosis
GPLD1	Glycosylphosphatidylinositol(GPI)-anchor biosynthesis
ECI2	Peroxisome
ECI2	Fatty acid metabolism
SUV39H1	Lysine degradation
PDGFA	Regulation of actin cytoskeleton
PDGFA	Focal adhesion
PDGFA	Gap junction
PRKAR2B	Apoptosis
PTGIS	Arachidonic acid metabolism
GPX4	Glutathione metabolism
VAMP3	SNARE interactions in vesicular transport
VAMP3	Phagosome
GMPS	Drug metabolism - other enzymes
GMPS	Purine metabolism
GABARAP	Regulation of autophagy
PDE6A	Purine metabolism
ALDH6A1	Inositol phosphate metabolism
ALDH6A1	Propanoate metabolism
ALDH6A1	Valine, leucine and isoleucine degradation
VPS45	Endocytosis
ATP6V1E1	Phagosome
ATP6V1E1	Oxidative phosphorylation
NCF2	Phagosome
SHFM1	Proteasome
SHFM1	Homologous recombination
POLR2J	RNA polymerase
POLR2J	Purine metabolism
POLR2J	Pyrimidine metabolism
FASN	Fatty acid biosynthesis
BDKRB1	Regulation of actin cytoskeleton
NCKAP1	Regulation of actin cytoskeleton
PGK2	Glycolysis / Gluconeogenesis
VEGFB	Focal adhesion
WARS2	Tryptophan metabolism
WARS2	Aminoacyl-tRNA biosynthesis
AGA	Other glycan degradation
AGA	Lysosome
XRCC2	Homologous recombination
SNRPE	Spliceosome
FUT3	Glycosphingolipid biosynthesis - lacto and neolacto series
RDH5	Retinol metabolism
B4GALT7	Glycosaminoglycan biosynthesis - chondroitin sulfate
B4GALT7	Glycosaminoglycan biosynthesis - heparan sulfate
FUT6	Glycosphingolipid biosynthesis - lacto and neolacto series
FUT1	Glycosphingolipid biosynthesis - lacto and neolacto series
FUT1	Glycosphingolipid biosynthesis - globo series
CPSF6	mRNA surveillance pathway
RRBP1	Protein processing in endoplasmic reticulum
CHST1	Glycosaminoglycan biosynthesis - keratan sulfate
ETF1	mRNA surveillance pathway
SPAM1	Glycosaminoglycan degradation
VAMP8	SNARE interactions in vesicular transport
LGMN	Lysosome
ASS1	Alanine, aspartate and glutamate metabolism
ASS1	Arginine and proline metabolism
IFNA10	Regulation of autophagy
HNRNPU	Spliceosome
RPN2	N-Glycan biosynthesis
RPN2	Protein processing in endoplasmic reticulum
EIF6	Ribosome biogenesis in eukaryotes
SETDB1	Lysine degradation
APEX1	Base excision repair
REC8	Oocyte meiosis
PSMD13	Proteasome
CYP4A11	Retinol metabolism
CYP4A11	Arachidonic acid metabolism
CYP4A11	Fatty acid metabolism
FUT2	Glycosphingolipid biosynthesis - lacto and neolacto series
FUT2	Glycosphingolipid biosynthesis - globo series
ESPL1	Cell cycle
ESPL1	Oocyte meiosis
MAN1A1	N-Glycan biosynthesis
MAN1A1	Protein processing in endoplasmic reticulum
ADCY7	Purine metabolism
ADCY7	Oocyte meiosis
ADCY7	Gap junction
TAF2	Basal transcription factors
ACLY	Citrate cycle (TCA cycle)
GTF2F2	Basal transcription factors
PSMD8	Proteasome
CYP26A1	Retinol metabolism
GUCY1A3	Purine metabolism
GUCY1A3	Gap junction
U2AF1	Spliceosome
AANAT	Tryptophan metabolism
TOP3A	Homologous recombination
EEA1	Endocytosis
EEA1	Phagosome
ACAA2	Valine, leucine and isoleucine degradation
ACAA2	Fatty acid elongation
ACAA2	Fatty acid metabolism
TCOF1	Ribosome biogenesis in eukaryotes
COX6C	Oxidative phosphorylation
CHST4	Glycosaminoglycan biosynthesis - keratan sulfate
CYP2F1	Metabolism of xenobiotics by cytochrome P450
AMD1	Cysteine and methionine metabolism
AMD1	Arginine and proline metabolism
NDUFB8	Oxidative phosphorylation
PDE2A	Purine metabolism
PDE4A	Purine metabolism
INADL	Tight junction
TPH1	Tryptophan metabolism
NUP50	RNA transport
ARHGAP5	Focal adhesion
TAF9	Basal transcription factors
TAF9	Ribosome biogenesis in eukaryotes
FDFT1	Steroid biosynthesis
TLR6	Phagosome
FUT7	Glycosphingolipid biosynthesis - lacto and neolacto series
FUT7	Other types of O-glycan biosynthesis
PIK3C2B	Inositol phosphate metabolism
NUDT21	mRNA surveillance pathway
PDE1A	Purine metabolism
MAP3K5	Protein processing in endoplasmic reticulum
MTMR2	Fructose and mannose metabolism
PRIM1	Purine metabolism
PRIM1	DNA replication
PRIM1	Pyrimidine metabolism
NUPL2	RNA transport
POLR2D	RNA polymerase
POLR2D	Purine metabolism
POLR2D	Pyrimidine metabolism
VCL	Regulation of actin cytoskeleton
VCL	Adherens junction
VCL	Focal adhesion
IBSP	Focal adhesion
SCARB2	Lysosome
MPG	Base excision repair
PRKCSH	Protein processing in endoplasmic reticulum
NDUFA3	Oxidative phosphorylation
PIGQ	Glycosylphosphatidylinositol(GPI)-anchor biosynthesis
ACADVL	Fatty acid metabolism
GTF2I	Basal transcription factors
PYGB	Starch and sucrose metabolism
RASGRF1	Focal adhesion
HAGH	Pyruvate metabolism
CD63	Lysosome
ITGA10	Regulation of actin cytoskeleton
ITGA10	Focal adhesion
ARHGAP35	Regulation of actin cytoskeleton
ARHGAP35	Focal adhesion
ERP29	Protein processing in endoplasmic reticulum
NDUFC1	Oxidative phosphorylation
SGSH	Glycosaminoglycan degradation
SGSH	Lysosome
PSPH	Glycine, serine and threonine metabolism
RAD21	Cell cycle
MAN1B1	N-Glycan biosynthesis
MAN1B1	Protein processing in endoplasmic reticulum
DNASE2	Lysosome
MTR	Selenocompound metabolism
MTR	Cysteine and methionine metabolism
MTR	One carbon pool by folate
CLDN2	Tight junction
NDUFS3	Oxidative phosphorylation
B4GALNT1	Glycosphingolipid biosynthesis - ganglio series
EPS15	Endocytosis
PLCB3	Inositol phosphate metabolism
PLCB3	Gap junction
P4HA2	Arginine and proline metabolism
GRHPR	Glyoxylate and dicarboxylate metabolism
GRHPR	Pyruvate metabolism
GABARAPL2	Regulation of autophagy
SOS1	Regulation of actin cytoskeleton
SOS1	Focal adhesion
SOS1	Gap junction
IFNA16	Regulation of autophagy
XRCC1	Base excision repair
GAL3ST1	Sphingolipid metabolism
PYCR1	Arginine and proline metabolism
PDE8A	Purine metabolism
ATF6B	Protein processing in endoplasmic reticulum
COX7A1	Oxidative phosphorylation
GSTA4	Glutathione metabolism
GSTA4	Metabolism of xenobiotics by cytochrome P450
GSTA4	Drug metabolism - cytochrome P450
GCLC	Glutathione metabolism
GDA	Purine metabolism
PLOD1	Lysine degradation
FTCD	Histidine metabolism
FTCD	One carbon pool by folate
CCNH	Basal transcription factors
CCNH	Cell cycle
CCNH	Nucleotide excision repair
GSTM3	Glutathione metabolism
GSTM3	Metabolism of xenobiotics by cytochrome P450
GSTM3	Drug metabolism - cytochrome P450
GCNT2	Glycosphingolipid biosynthesis - lacto and neolacto series
BPNT1	Sulfur metabolism
OCRL	Inositol phosphate metabolism
ATP5C1	Oxidative phosphorylation
PNMT	Tyrosine metabolism
AIFM1	Apoptosis
WWP2	Ubiquitin mediated proteolysis
GSTM4	Glutathione metabolism
GSTM4	Metabolism of xenobiotics by cytochrome P450
GSTM4	Drug metabolism - cytochrome P450
ACP2	Lysosome
ACP2	Riboflavin metabolism
PAH	Phenylalanine metabolism
PAH	Phenylalanine, tyrosine and tryptophan biosynthesis
BIRC2	Ubiquitin mediated proteolysis
BIRC2	Focal adhesion
BIRC2	Apoptosis
POLR2F	RNA polymerase
POLR2F	Purine metabolism
POLR2F	Pyrimidine metabolism
PDE4B	Purine metabolism
CLTC	Endocytosis
CLTC	Lysosome
GSTT2	Glutathione metabolism
GSTT2	Metabolism of xenobiotics by cytochrome P450
GSTT2	Drug metabolism - cytochrome P450
ATP5D	Oxidative phosphorylation
ITGAE	Regulation of actin cytoskeleton
ALOX15	Linoleic acid metabolism
ALOX15	Arachidonic acid metabolism
CKB	Arginine and proline metabolism
THOC5	RNA transport
CTNND1	Adherens junction
CYP4F3	Arachidonic acid metabolism
PDE8B	Purine metabolism
VAMP2	SNARE interactions in vesicular transport
FUT4	Glycosphingolipid biosynthesis - lacto and neolacto series
FUT4	Other types of O-glycan biosynthesis
CHRM5	Regulation of actin cytoskeleton
SOAT2	Steroid biosynthesis
CUL4A	Ubiquitin mediated proteolysis
CUL4A	Nucleotide excision repair
RPN1	N-Glycan biosynthesis
RPN1	Protein processing in endoplasmic reticulum
WWP1	Endocytosis
WWP1	Ubiquitin mediated proteolysis
GPX5	Glutathione metabolism
GPX5	Arachidonic acid metabolism
ACY1	Arginine and proline metabolism
POLR2E	RNA polymerase
POLR2E	Purine metabolism
POLR2E	Pyrimidine metabolism
PEX5	Peroxisome
TNR	Focal adhesion
ARHGEF7	Regulation of actin cytoskeleton
KMO	Tryptophan metabolism
ATP5E	Oxidative phosphorylation
COX17	Oxidative phosphorylation
CUL2	Ubiquitin mediated proteolysis
LCT	Galactose metabolism
CUL4B	Ubiquitin mediated proteolysis
CUL4B	Nucleotide excision repair
QDPR	Folate biosynthesis
CDC25C	Cell cycle
CDC25C	Oocyte meiosis
FGF18	Regulation of actin cytoskeleton
NDUFB3	Oxidative phosphorylation
COX5A	Oxidative phosphorylation
FPGS	Folate biosynthesis
EIF5B	RNA transport
CBR3	Arachidonic acid metabolism
GANC	Starch and sucrose metabolism
GANC	Galactose metabolism
MPV17	Peroxisome
ACPP	Riboflavin metabolism
NCBP1	mRNA surveillance pathway
NCBP1	RNA transport
NCBP1	Spliceosome
MYH1	Tight junction
DLAT	Pyruvate metabolism
DLAT	Glycolysis / Gluconeogenesis
DLAT	Citrate cycle (TCA cycle)
ENTPD5	Purine metabolism
ENTPD5	Pyrimidine metabolism
GLUL	Alanine, aspartate and glutamate metabolism
GLUL	Arginine and proline metabolism
GLUL	Nitrogen metabolism
BTG1	RNA degradation
SLC33A1	Glycosphingolipid biosynthesis - ganglio series
CHST2	Glycosaminoglycan biosynthesis - keratan sulfate
B4GALT5	Mucin type O-Glycan biosynthesis
SNRPA1	Spliceosome
NDUFS4	Oxidative phosphorylation
EIF2B1	RNA transport
GTF2IRD1	Basal transcription factors
CPSF4	mRNA surveillance pathway
STS	Steroid hormone biosynthesis
CYP46A1	Primary bile acid biosynthesis
BHMT	Cysteine and methionine metabolism
BHMT	Glycine, serine and threonine metabolism
CSF2RB	Apoptosis
RNGTT	mRNA surveillance pathway
SNAP29	SNARE interactions in vesicular transport
GGH	Folate biosynthesis
PIAS2	Ubiquitin mediated proteolysis
PPP2R2C	mRNA surveillance pathway
PPP2R2C	Tight junction
INPP4A	Inositol phosphate metabolism
EIF3H	RNA transport
PTPRB	Adherens junction
EIF3D	RNA transport
GNS	Glycosaminoglycan degradation
GNS	Lysosome
PPP2R5B	mRNA surveillance pathway
PPP2R5B	Oocyte meiosis
FUT9	Glycosphingolipid biosynthesis - lacto and neolacto series
FUT9	Other types of O-glycan biosynthesis
FUT9	Glycosphingolipid biosynthesis - globo series
GUCY1A2	Purine metabolism
GUCY1A2	Gap junction
ACADS	Valine, leucine and isoleucine degradation
ACADS	Butanoate metabolism
ACADS	Fatty acid metabolism
ATP6V1F	Phagosome
ATP6V1F	Oxidative phosphorylation
OXA1L	Protein export
HYAL3	Glycosaminoglycan degradation
WASF3	Adherens junction
MAD1L1	Cell cycle
LAMA4	Focal adhesion
RAD51D	Homologous recombination
LLGL1	Tight junction
G6PC	Glycolysis / Gluconeogenesis
G6PC	Starch and sucrose metabolism
G6PC	Galactose metabolism
FGF9	Regulation of actin cytoskeleton
PDE3A	Purine metabolism
PLD2	Endocytosis
PLD2	Glycerophospholipid metabolism
PLD2	Ether lipid metabolism
STX16	SNARE interactions in vesicular transport
COX10	Porphyrin and chlorophyll metabolism
COX10	Oxidative phosphorylation
CHAD	Focal adhesion
COX4I1	Oxidative phosphorylation
EPB41L1	Tight junction
DBT	Valine, leucine and isoleucine degradation
NOS2	Arginine and proline metabolism
NOS2	Peroxisome
TAF11	Basal transcription factors
PEX3	Peroxisome
EIF3B	RNA transport
INPP1	Inositol phosphate metabolism
MAGOH	mRNA surveillance pathway
MAGOH	RNA transport
MAGOH	Spliceosome
GNA13	Regulation of actin cytoskeleton
POM121	RNA transport
UBA1	Ubiquitin mediated proteolysis
ELK1	Focal adhesion
GTF2H1	Basal transcription factors
GTF2H1	Nucleotide excision repair
IMPDH2	Drug metabolism - other enzymes
IMPDH2	Purine metabolism
NDUFS5	Oxidative phosphorylation
IFNA14	Regulation of autophagy
WFS1	Protein processing in endoplasmic reticulum
GSN	Regulation of actin cytoskeleton
UQCRH	Oxidative phosphorylation
IL1R1	Apoptosis
GNPAT	Glycerophospholipid metabolism
GNPAT	Peroxisome
PLA2G7	Ether lipid metabolism
IL2RB	Endocytosis
IGFBP3	p53 signaling pathway
LAMB1	Focal adhesion
PAICS	Purine metabolism
ENTPD4	Lysosome
ENTPD4	Purine metabolism
ENTPD4	Pyrimidine metabolism
ATP5G2	Oxidative phosphorylation
ST8SIA1	Glycosphingolipid biosynthesis - lacto and neolacto series
ST8SIA1	Glycosphingolipid biosynthesis - ganglio series
ST8SIA1	Glycosphingolipid biosynthesis - globo series
RPE65	Retinol metabolism
PRKAR1B	Apoptosis
DNMT3B	Cysteine and methionine metabolism
RAD52	Homologous recombination
AKR1A1	Glycolysis / Gluconeogenesis
AKR1A1	Glycerolipid metabolism
FOLR2	Endocytosis
DHCR7	Steroid biosynthesis
ADRB1	Endocytosis
ADRB1	Gap junction
MPI	Fructose and mannose metabolism
MPI	Amino sugar and nucleotide sugar metabolism
AP2A1	Endocytosis
CTSE	Lysosome
PAPSS1	Selenocompound metabolism
PAPSS1	Sulfur metabolism
PAPSS1	Purine metabolism
PARP1	Base excision repair
VNN1	Pantothenate and CoA biosynthesis
IFNA17	Regulation of autophagy
HSD17B6	Steroid hormone biosynthesis
FGF4	Regulation of actin cytoskeleton
SHMT2	Glycine, serine and threonine metabolism
SHMT2	One carbon pool by folate
SHMT2	Cyanoamino acid metabolism
MYH10	Regulation of actin cytoskeleton
MYH10	Tight junction
CCNG2	p53 signaling pathway
IFNA5	Regulation of autophagy
MANBA	Other glycan degradation
MANBA	Lysosome
FGD1	Regulation of actin cytoskeleton
IFNA6	Regulation of autophagy
POLR2H	RNA polymerase
POLR2H	Purine metabolism
POLR2H	Pyrimidine metabolism
CRAT	Peroxisome
MOCS2	Folate biosynthesis
MOCS2	Sulfur relay system
KYNU	Tryptophan metabolism
GTF2B	Basal transcription factors
WASL	Regulation of actin cytoskeleton
WASL	Adherens junction
TFDP2	Cell cycle
C1R	Phagosome
DBF4	Cell cycle
NDUFS8	Oxidative phosphorylation
EIF1	RNA transport
PRPF3	Spliceosome
MRC2	Phagosome
CDC14A	Cell cycle
CDC16	Ubiquitin mediated proteolysis
CDC16	Cell cycle
CDC16	Oocyte meiosis
EI24	p53 signaling pathway
SH3GL3	Endocytosis
KHK	Fructose and mannose metabolism
SI	Starch and sucrose metabolism
FMO3	Drug metabolism - cytochrome P450
TAF15	Basal transcription factors
ST3GAL6	Glycosphingolipid biosynthesis - lacto and neolacto series
NAGA	Lysosome
NAGA	Glycosphingolipid biosynthesis - globo series
PDE3B	Purine metabolism
CCNE2	Cell cycle
CCNE2	p53 signaling pathway
CCNE2	Oocyte meiosis
IDH3B	Citrate cycle (TCA cycle)
ADCY8	Purine metabolism
ADCY8	Oocyte meiosis
ADCY8	Gap junction
MVD	Terpenoid backbone biosynthesis
IDH3A	Citrate cycle (TCA cycle)
BAI1	p53 signaling pathway
PPP2R5E	mRNA surveillance pathway
PPP2R5E	Oocyte meiosis
SORD	Fructose and mannose metabolism
PLCB2	Inositol phosphate metabolism
PLCB2	Gap junction
IFNA8	Regulation of autophagy
ALDOA	Fructose and mannose metabolism
ALDOA	Glycolysis / Gluconeogenesis
ALDOA	Pentose phosphate pathway
GEMIN2	RNA transport
PCBP1	Spliceosome
PLOD2	Lysine degradation
ZYX	Focal adhesion
SF3B2	Spliceosome
DOCK1	Regulation of actin cytoskeleton
DOCK1	Focal adhesion
E2F5	Cell cycle
CBR1	Arachidonic acid metabolism
NDUFA1	Oxidative phosphorylation
GYS2	Starch and sucrose metabolism
APRT	Purine metabolism
CH25H	Primary bile acid biosynthesis
RPL14	Ribosome
DLST	Lysine degradation
DLST	Citrate cycle (TCA cycle)
SETD1A	Lysine degradation
ZFYVE9	Endocytosis
AGPAT2	Glycerophospholipid metabolism
AGPAT2	Glycerolipid metabolism
CCBL1	Tryptophan metabolism
CCBL1	Selenocompound metabolism
IL1RAP	Apoptosis
EIF2B4	RNA transport
SNRPC	Spliceosome
TDO2	Tryptophan metabolism
HLA-DMB	Phagosome
PEX14	Peroxisome
CYP7B1	Steroid hormone biosynthesis
CYP7B1	Primary bile acid biosynthesis
ACP1	Adherens junction
ACP1	Riboflavin metabolism
ABCD3	Peroxisome
GK	Glycerolipid metabolism
HLCS	Biotin metabolism
PGK1	Glycolysis / Gluconeogenesis
FOLR1	Endocytosis
ALDH5A1	Alanine, aspartate and glutamate metabolism
ALDH5A1	Butanoate metabolism
CLTB	Endocytosis
CLTB	Lysosome
SARDH	Glycine, serine and threonine metabolism
BCKDHA	Valine, leucine and isoleucine degradation
GPAA1	Glycosylphosphatidylinositol(GPI)-anchor biosynthesis
HSD11B2	Steroid hormone biosynthesis
C1D	RNA degradation
ATP5O	Oxidative phosphorylation
PGAM1	Glycolysis / Gluconeogenesis
ATP5H	Oxidative phosphorylation
CHRM2	Regulation of actin cytoskeleton
AHCY	Cysteine and methionine metabolism
DNMT3L	Cysteine and methionine metabolism
ACER3	Sphingolipid metabolism
SH3KBP1	Endocytosis
TP53AIP1	p53 signaling pathway
CHMP2B	Endocytosis
DMGDH	Glycine, serine and threonine metabolism
GJD2	Gap junction
ENAH	Regulation of actin cytoskeleton
CHSY1	Glycosaminoglycan biosynthesis - chondroitin sulfate
MYH7B	Tight junction
NPLOC4	Protein processing in endoplasmic reticulum
PDE11A	Purine metabolism
IMMP2L	Protein export
LSM3	RNA degradation
LSM3	Spliceosome
PLA2G15	Glycerophospholipid metabolism
PLA2G15	Lysosome
SMPD3	Sphingolipid metabolism
FIP1L1	mRNA surveillance pathway
XPO5	RNA transport
CTNNBL1	Spliceosome
POLA2	Purine metabolism
POLA2	DNA replication
POLA2	Pyrimidine metabolism
FBXO2	Ubiquitin mediated proteolysis
FBXO2	Protein processing in endoplasmic reticulum
ATG4B	Regulation of autophagy
RDH11	Retinol metabolism
CHDH	Glycine, serine and threonine metabolism
HSD17B12	Biosynthesis of unsaturated fatty acids
HSD17B12	Steroid hormone biosynthesis
C1GALT1	Mucin type O-Glycan biosynthesis
UPF3A	mRNA surveillance pathway
UPF3A	RNA transport
PI4K2A	Inositol phosphate metabolism
GALNT11	Mucin type O-Glycan biosynthesis
NHEJ1	Non-homologous end-joining
FBXO4	Ubiquitin mediated proteolysis
TRIM32	Ubiquitin mediated proteolysis
MCCC1	Valine, leucine and isoleucine degradation
NSD1	Lysine degradation
ZNRD1	RNA polymerase
ZNRD1	Purine metabolism
ZNRD1	Pyrimidine metabolism
GABARAPL1	Regulation of autophagy
CLDN15	Tight junction
CTNNA3	Adherens junction
CTNNA3	Tight junction
POLR1B	RNA polymerase
POLR1B	Purine metabolism
POLR1B	Pyrimidine metabolism
SEC31A	Protein processing in endoplasmic reticulum
LAMP3	Lysosome
EPN1	Endocytosis
SSH1	Regulation of actin cytoskeleton
PELO	mRNA surveillance pathway
FANCL	Ubiquitin mediated proteolysis
SMUG1	Base excision repair
ANAPC4	Ubiquitin mediated proteolysis
ANAPC4	Cell cycle
ANAPC4	Oocyte meiosis
IPPK	Inositol phosphate metabolism
SLC17A5	Lysosome
FGF20	Regulation of actin cytoskeleton
SBDS	Ribosome biogenesis in eukaryotes
STX17	SNARE interactions in vesicular transport
LIPT1	Lipoic acid metabolism
DCP1A	RNA degradation
CLEC7A	Phagosome
NUP133	RNA transport
SUMO3	RNA transport
SHC3	Focal adhesion
PARVA	Focal adhesion
RNASEH2B	DNA replication
CLDN17	Tight junction
POMP	Proteasome
CNDP1	Histidine metabolism
CNDP1	beta-Alanine metabolism
PRODH	Arginine and proline metabolism
NUP62	RNA transport
ERO1L	Protein processing in endoplasmic reticulum
ETNK2	Glycerophospholipid metabolism
L2HGDH	Butanoate metabolism
POGLUT1	Other types of O-glycan biosynthesis
RAB11FIP2	Endocytosis
PTGES2	Arachidonic acid metabolism
XRN2	RNA degradation
XRN2	Ribosome biogenesis in eukaryotes
PRPF40A	Spliceosome
GSPT2	mRNA surveillance pathway
ATP6V1H	Phagosome
ATP6V1H	Lysosome
ATP6V1H	Oxidative phosphorylation
CPSF7	mRNA surveillance pathway
MLYCD	Propanoate metabolism
MLYCD	beta-Alanine metabolism
MLYCD	Peroxisome
HSD17B7	Steroid hormone biosynthesis
HSD17B7	Steroid biosynthesis
DROSHA	Ribosome biogenesis in eukaryotes
CNOT6	RNA degradation
PDSS1	Terpenoid backbone biosynthesis
PPP1R15A	Protein processing in endoplasmic reticulum
RAD54B	Homologous recombination
TAF5L	Basal transcription factors
NMNAT2	Nicotinate and nicotinamide metabolism
PRPF6	Spliceosome
CLDN20	Tight junction
FBXW11	Ubiquitin mediated proteolysis
FBXW11	Oocyte meiosis
POMGNT1	Other types of O-glycan biosynthesis
G6PC2	Glycolysis / Gluconeogenesis
G6PC2	Starch and sucrose metabolism
G6PC2	Galactose metabolism
PLA2R1	Phagosome
GGCT	Glutathione metabolism
PARD6A	Endocytosis
PARD6A	Tight junction
MCOLN1	Lysosome
RPRM	p53 signaling pathway
POLL	Non-homologous end-joining
POLL	Base excision repair
GNG12	Regulation of actin cytoskeleton
DYNC2H1	Phagosome
PLCD4	Inositol phosphate metabolism
LSM2	RNA degradation
LSM2	Spliceosome
PIAS4	Ubiquitin mediated proteolysis
PHGDH	Glycine, serine and threonine metabolism
SESN1	p53 signaling pathway
XYLT1	Glycosaminoglycan biosynthesis - chondroitin sulfate
XYLT1	Glycosaminoglycan biosynthesis - heparan sulfate
MYH14	Regulation of actin cytoskeleton
MYH14	Tight junction
SUMO2	RNA transport
EHD3	Endocytosis
PLCB1	Inositol phosphate metabolism
PLCB1	Gap junction
ZMAT3	p53 signaling pathway
AKR1B10	Linoleic acid metabolism
AKR1B10	Fructose and mannose metabolism
AKR1B10	Butanoate metabolism
EHMT1	Lysine degradation
POLR1E	RNA polymerase
POLR1E	Purine metabolism
POLR1E	Pyrimidine metabolism
PIDD	p53 signaling pathway
GAR1	Ribosome biogenesis in eukaryotes
SIL1	Protein processing in endoplasmic reticulum
NHP2	Ribosome biogenesis in eukaryotes
DGAT2	Glycerolipid metabolism
FGF22	Regulation of actin cytoskeleton
DCPS	RNA degradation
LSM1	RNA degradation
HPGDS	Arachidonic acid metabolism
CLDN14	Tight junction
CPEB1	Oocyte meiosis
ANAPC5	Ubiquitin mediated proteolysis
ANAPC5	Cell cycle
ANAPC5	Oocyte meiosis
POLM	Non-homologous end-joining
FBXO5	Oocyte meiosis
CYP26B1	Retinol metabolism
DCLRE1C	Non-homologous end-joining
NEIL1	Base excision repair
NEIL2	Base excision repair
MYC	Cell cycle
BUB1B	Cell cycle
RNASEH1	DNA replication
PPOX	Porphyrin and chlorophyll metabolism
SDHC	Oxidative phosphorylation
SDHC	Citrate cycle (TCA cycle)
ADA	Purine metabolism
LCMT1	Histidine metabolism
LCMT1	Tyrosine metabolism
ADC	Arginine and proline metabolism
GSTT1	Glutathione metabolism
GSTT1	Metabolism of xenobiotics by cytochrome P450
GSTT1	Drug metabolism - cytochrome P450
NHLRC1	Ubiquitin mediated proteolysis
CXCR1	Endocytosis
SSX2IP	Adherens junction
EPHX1	Metabolism of xenobiotics by cytochrome P450
CDC26	Ubiquitin mediated proteolysis
CDC26	Cell cycle
CDC26	Oocyte meiosis
SERPINB5	p53 signaling pathway
IDH2	Glutathione metabolism
IDH2	Citrate cycle (TCA cycle)
IDH2	Peroxisome
AGAP2	Endocytosis
PTGES	Arachidonic acid metabolism
CKM	Arginine and proline metabolism
CYP2J2	Linoleic acid metabolism
CYP2J2	Arachidonic acid metabolism
CD82	p53 signaling pathway
NDUFS7	Oxidative phosphorylation
RBM17	Spliceosome
PNPT1	RNA degradation
PNPT1	Purine metabolism
PNPT1	Pyrimidine metabolism
GSTA1	Glutathione metabolism
GSTA1	Metabolism of xenobiotics by cytochrome P450
GSTA1	Drug metabolism - cytochrome P450
SMN2	RNA transport
RBL2	Cell cycle
GRB2	Focal adhesion
GRB2	Gap junction
GNPDA2	Amino sugar and nucleotide sugar metabolism
IDO2	Tryptophan metabolism
XRCC5	Non-homologous end-joining
TAF1L	Basal transcription factors
RPE	Pentose and glucuronate interconversions
RPE	Pentose phosphate pathway
PMAIP1	p53 signaling pathway
DGKH	Glycerophospholipid metabolism
DGKH	Glycerolipid metabolism
RAD23A	Protein processing in endoplasmic reticulum
RAD23A	Nucleotide excision repair
ACMSD	Tryptophan metabolism
HS6ST3	Glycosaminoglycan biosynthesis - heparan sulfate
NUP35	RNA transport
TGS1	RNA transport
GSTA5	Glutathione metabolism
GSTA5	Metabolism of xenobiotics by cytochrome P450
GSTA5	Drug metabolism - cytochrome P450
ERBB3	Endocytosis
MOGAT3	Glycerolipid metabolism
AWAT2	Retinol metabolism
PIGA	Glycosylphosphatidylinositol(GPI)-anchor biosynthesis
ABL1	Cell cycle
RANGAP1	RNA transport
CA1	Nitrogen metabolism
TYMP	Drug metabolism - other enzymes
TYMP	Pyrimidine metabolism
IKBKG	Apoptosis
TUSC3	N-Glycan biosynthesis
TUSC3	Protein processing in endoplasmic reticulum
ARAP1	Endocytosis
GALM	Glycolysis / Gluconeogenesis
BCL2L1	Apoptosis
FGF19	Regulation of actin cytoskeleton
ITGB8	Regulation of actin cytoskeleton
ITGB8	Focal adhesion
B3GAT2	Glycosaminoglycan biosynthesis - chondroitin sulfate
B3GAT2	Glycosaminoglycan biosynthesis - heparan sulfate
WAS	Regulation of actin cytoskeleton
WAS	Adherens junction
ITGB6	Regulation of actin cytoskeleton
ITGB6	Focal adhesion
CCNB3	Cell cycle
CCNB3	p53 signaling pathway
BAK1	Protein processing in endoplasmic reticulum
IQGAP1	Regulation of actin cytoskeleton
IQGAP1	Adherens junction
CTSK	Lysosome
GAMT	Glycine, serine and threonine metabolism
GAMT	Arginine and proline metabolism
NAGS	Arginine and proline metabolism
BRCA2	Homologous recombination
EIF3E	RNA transport
PHPT1	Fructose and mannose metabolism
CTNNA1	Adherens junction
CTNNA1	Tight junction
PLCD3	Inositol phosphate metabolism
TJP1	Adherens junction
TJP1	Tight junction
TJP1	Gap junction
CANT1	Purine metabolism
CANT1	Pyrimidine metabolism
PANK2	Pantothenate and CoA biosynthesis
DCP2	RNA degradation
OCLN	Tight junction
RPL37A	Ribosome
BPGM	Glycolysis / Gluconeogenesis
UMPS	Drug metabolism - other enzymes
UMPS	Pyrimidine metabolism
PANK1	Pantothenate and CoA biosynthesis
TECR	Biosynthesis of unsaturated fatty acids
JAM3	Tight junction
SORT1	Lysosome
ATP5G1	Oxidative phosphorylation
ST3GAL4	Glycosphingolipid biosynthesis - lacto and neolacto series
HLA-E	Endocytosis
HLA-E	Phagosome
LIPC	Glycerolipid metabolism
BTD	Biotin metabolism
ITGAM	Regulation of actin cytoskeleton
ITGAM	Phagosome
SRR	Glycine, serine and threonine metabolism
LCAT	Glycerophospholipid metabolism
PEMT	Glycerophospholipid metabolism
CDKN2B	Cell cycle
TNXB	Focal adhesion
HLA-DQB1	Phagosome
GNPTAB	Lysosome
PDGFD	Regulation of actin cytoskeleton
PDGFD	Focal adhesion
PDGFD	Gap junction
HLA-DQA2	Phagosome
MID1	Ubiquitin mediated proteolysis
PNPLA3	Glycerolipid metabolism
IGSF5	Tight junction
LAMC2	Focal adhesion
COL4A2	Focal adhesion
SNF8	Endocytosis
SPTLC3	Sphingolipid metabolism
NT5C2	Nicotinate and nicotinamide metabolism
NT5C2	Purine metabolism
NT5C2	Pyrimidine metabolism
HLA-DPA1	Phagosome
EDC4	RNA degradation
LPL	Glycerolipid metabolism
HLA-DPB1	Phagosome
LIPA	Steroid biosynthesis
LIPA	Lysosome
E2F4	Cell cycle
ADI1	Cysteine and methionine metabolism
LAMA1	Focal adhesion
APC	Regulation of actin cytoskeleton
DAB2	Endocytosis
VASP	Focal adhesion
CALR	Phagosome
CALR	Protein processing in endoplasmic reticulum
CCR5	Endocytosis
TGFB3	Endocytosis
TGFB3	Cell cycle
ARG1	Arginine and proline metabolism
ARHGEF1	Regulation of actin cytoskeleton
NDST1	Glycosaminoglycan biosynthesis - heparan sulfate
CD38	Nicotinate and nicotinamide metabolism
NDUFS1	Oxidative phosphorylation
SDHB	Oxidative phosphorylation
SDHB	Citrate cycle (TCA cycle)
CLEC4M	Phagosome
MAGI1	Tight junction
CHRM3	Regulation of actin cytoskeleton
CAPN1	Apoptosis
CAPN1	Protein processing in endoplasmic reticulum
VEGFC	Focal adhesion
CDKN1C	Cell cycle
MPO	Phagosome
COMT	Steroid hormone biosynthesis
COMT	Tyrosine metabolism
ALDH1L1	One carbon pool by folate
SMPD1	Sphingolipid metabolism
SMPD1	Lysosome
HERPUD1	Protein processing in endoplasmic reticulum
MAD2L1	Cell cycle
MAD2L1	Oocyte meiosis
PARP3	Base excision repair
SRD5A2	Steroid hormone biosynthesis
BBC3	p53 signaling pathway
VWF	Focal adhesion
RB1	Cell cycle
PLCG1	Inositol phosphate metabolism
ITGB3	Regulation of actin cytoskeleton
ITGB3	Phagosome
ITGB3	Focal adhesion
RELN	Focal adhesion
BUB1	Cell cycle
BUB1	Oocyte meiosis
CFLAR	Apoptosis
ITGA2B	Regulation of actin cytoskeleton
ITGA2B	Focal adhesion
MDM4	p53 signaling pathway
CLDN3	Tight junction
XPA	Nucleotide excision repair
ALDOB	Fructose and mannose metabolism
ALDOB	Glycolysis / Gluconeogenesis
ALDOB	Pentose phosphate pathway
FGF1	Regulation of actin cytoskeleton
KEAP1	Ubiquitin mediated proteolysis
CLDN7	Tight junction
ITGAV	Regulation of actin cytoskeleton
ITGAV	Phagosome
ITGAV	Focal adhesion
TYMS	One carbon pool by folate
TYMS	Pyrimidine metabolism
DRD2	Gap junction
CA2	Nitrogen metabolism
IL1A	Apoptosis
FADD	Apoptosis
CHAT	Glycerophospholipid metabolism
PSAT1	Glycine, serine and threonine metabolism
PSAT1	Vitamin B6 metabolism
HPSE	Glycosaminoglycan degradation
CTSS	Phagosome
CTSS	Lysosome
TPH2	Tryptophan metabolism
F2R	Endocytosis
F2R	Regulation of actin cytoskeleton
SLC11A1	Lysosome
VAV2	Regulation of actin cytoskeleton
VAV2	Focal adhesion
ALDH1A1	Retinol metabolism
CPS1	Alanine, aspartate and glutamate metabolism
CPS1	Arginine and proline metabolism
CPS1	Nitrogen metabolism
ASMT	Tryptophan metabolism
NDUFS2	Oxidative phosphorylation
GBE1	Starch and sucrose metabolism
KLHL13	Ubiquitin mediated proteolysis
PEX11B	Peroxisome
CTNNA2	Adherens junction
CTNNA2	Tight junction
ALDH4A1	Alanine, aspartate and glutamate metabolism
ALDH4A1	Arginine and proline metabolism
NAGK	Amino sugar and nucleotide sugar metabolism
FCGR2C	Phagosome
RFK	Riboflavin metabolism
TMLHE	Lysine degradation
BAG1	Protein processing in endoplasmic reticulum
CLTCL1	Endocytosis
CLTCL1	Lysosome
GCAT	Glycine, serine and threonine metabolism
PPP2R2A	mRNA surveillance pathway
PPP2R2A	Tight junction
EIF2B3	RNA transport
SMAD3	Endocytosis
SMAD3	Adherens junction
SMAD3	Cell cycle
PPP2R3A	mRNA surveillance pathway
DIAPH3	Regulation of actin cytoskeleton
SMPD4	Sphingolipid metabolism
CCDC12	Spliceosome
COX7A2	Oxidative phosphorylation
TJAP1	Tight junction
EPB41	Tight junction
NXF5	mRNA surveillance pathway
NXF5	RNA transport
NXF5	Ribosome biogenesis in eukaryotes
PSMD1	Proteasome
ADCY10	Purine metabolism
ATG12	Regulation of autophagy
GGA3	Lysosome
SUV39H2	Lysine degradation
TAF7L	Basal transcription factors
TCF7L2	Adherens junction
ISYNA1	Inositol phosphate metabolism
GTF2H2D	Basal transcription factors
GTF2H2D	Nucleotide excision repair
MNAT1	Basal transcription factors
MNAT1	Nucleotide excision repair
HYI	Glyoxylate and dicarboxylate metabolism
CUL7	Ubiquitin mediated proteolysis
NUP210L	RNA transport
PYGM	Starch and sucrose metabolism
IVD	Valine, leucine and isoleucine degradation
AMDHD2	Amino sugar and nucleotide sugar metabolism
GTF2A1L	Basal transcription factors
HPD	Phenylalanine metabolism
HPD	Tyrosine metabolism
HPD	Ubiquinone and other terpenoid-quinone biosynthesis
ASNS	Alanine, aspartate and glutamate metabolism
ASNS	Nitrogen metabolism
LHPP	Oxidative phosphorylation
GALNT4	Mucin type O-Glycan biosynthesis
BRK1	Regulation of actin cytoskeleton
CLDN23	Tight junction
PIGY	Glycosylphosphatidylinositol(GPI)-anchor biosynthesis
SMG6	mRNA surveillance pathway
PIGT	Glycosylphosphatidylinositol(GPI)-anchor biosynthesis
EXT2	Glycosaminoglycan biosynthesis - heparan sulfate
SUCLG2	Propanoate metabolism
SUCLG2	Citrate cycle (TCA cycle)
COQ7	Ubiquinone and other terpenoid-quinone biosynthesis
PIGX	Glycosylphosphatidylinositol(GPI)-anchor biosynthesis
UTP14A	Ribosome biogenesis in eukaryotes
UBXN6	Protein processing in endoplasmic reticulum
AMPD1	Purine metabolism
CARNS1	Histidine metabolism
CARNS1	beta-Alanine metabolism
CARNS1	Arginine and proline metabolism
NDUFV1	Oxidative phosphorylation
PDCD6IP	Endocytosis
PAN3	RNA degradation
ENTPD1	Purine metabolism
ENTPD1	Pyrimidine metabolism
BCAT1	Pantothenate and CoA biosynthesis
BCAT1	Valine, leucine and isoleucine degradation
BCAT1	Valine, leucine and isoleucine biosynthesis
TAF6	Basal transcription factors
SMG7	mRNA surveillance pathway
PIKFYVE	Inositol phosphate metabolism
PIKFYVE	Regulation of actin cytoskeleton
PIKFYVE	Phagosome
IQSEC3	Endocytosis
FLAD1	Riboflavin metabolism
NDUFB4	Oxidative phosphorylation
RPS17L	Ribosome
SPCS3	Protein export
PNPLA6	Glycerophospholipid metabolism
PAFAH1B2	Ether lipid metabolism
ME2	Pyruvate metabolism
FGF13	Regulation of actin cytoskeleton
COQ2	Ubiquinone and other terpenoid-quinone biosynthesis
AKR1D1	Steroid hormone biosynthesis
AKR1D1	Primary bile acid biosynthesis
GYS1	Starch and sucrose metabolism
AMACR	Primary bile acid biosynthesis
AMACR	Peroxisome
EXOC3	Tight junction
FLNB	Focal adhesion
NCKAP1L	Regulation of actin cytoskeleton
NDUFA2	Oxidative phosphorylation
PDE1C	Purine metabolism
UFD1L	Protein processing in endoplasmic reticulum
TK2	Drug metabolism - other enzymes
TK2	Pyrimidine metabolism
TPK1	Thiamine metabolism
SUMF1	Lysosome
FHIT	Purine metabolism
HPSE2	Glycosaminoglycan degradation
ELAC2	RNA transport
MINPP1	Inositol phosphate metabolism
NDUFA13	Oxidative phosphorylation
NDUFA11	Oxidative phosphorylation
VAMP4	SNARE interactions in vesicular transport
MFNG	Other types of O-glycan biosynthesis
EME1	Homologous recombination
PTTG2	Cell cycle
PTTG2	Oocyte meiosis
UCKL1	Drug metabolism - other enzymes
UCKL1	Pyrimidine metabolism
RIOK2	Ribosome biogenesis in eukaryotes
STX1A	SNARE interactions in vesicular transport
PPP2R5C	mRNA surveillance pathway
PPP2R5C	Oocyte meiosis
CHMP1B	Endocytosis
RBM28	Ribosome biogenesis in eukaryotes
MOGS	N-Glycan biosynthesis
MOGS	Protein processing in endoplasmic reticulum
MGAT4A	N-Glycan biosynthesis
PPP2R1B	mRNA surveillance pathway
PPP2R1B	Tight junction
PPP2R1B	Oocyte meiosis
UROC1	Histidine metabolism
B3GNT6	Mucin type O-Glycan biosynthesis
PYGL	Starch and sucrose metabolism
SLC27A2	Peroxisome
TCF7	Adherens junction
GSTO2	Glutathione metabolism
GSTO2	Metabolism of xenobiotics by cytochrome P450
GSTO2	Drug metabolism - cytochrome P450
TNFSF10	Apoptosis
NEU4	Other glycan degradation
NEU4	Sphingolipid metabolism
GNAI2	Tight junction
GNAI2	Gap junction
TJP2	Tight junction
TXNRD1	Selenocompound metabolism
TXNRD1	Pyrimidine metabolism
RHOBTB2	Ubiquitin mediated proteolysis
EIF4G1	RNA transport
COL11A2	Focal adhesion
PLCE1	Inositol phosphate metabolism
BCAT2	Pantothenate and CoA biosynthesis
BCAT2	Valine, leucine and isoleucine degradation
BCAT2	Valine, leucine and isoleucine biosynthesis
SEPSECS	Selenocompound metabolism
SEPSECS	Aminoacyl-tRNA biosynthesis
SETDB2	Lysine degradation
COL11A1	Focal adhesion
MBOAT7	Glycerophospholipid metabolism
ERCC1	Nucleotide excision repair
PARD3	Endocytosis
PARD3	Adherens junction
PARD3	Tight junction
GALNT12	Mucin type O-Glycan biosynthesis
FGF16	Regulation of actin cytoskeleton
FGF8	Regulation of actin cytoskeleton
HSD3B2	Steroid hormone biosynthesis
CYP21A2	Steroid hormone biosynthesis
MMAB	Porphyrin and chlorophyll metabolism
ORC6	Cell cycle
HLA-DRA	Phagosome
HTR2A	Gap junction
CDC6	Cell cycle
F2	Regulation of actin cytoskeleton
PDE4D	Purine metabolism
CASP8	p53 signaling pathway
CASP8	Apoptosis
FAH	Tyrosine metabolism
RAPGEF1	Focal adhesion
FTL	Porphyrin and chlorophyll metabolism
COL1A2	Focal adhesion
SOD2	Peroxisome
COLEC11	Phagosome
FTH1	Porphyrin and chlorophyll metabolism
CD209	Phagosome
CA8	Nitrogen metabolism
IGF1	p53 signaling pathway
IGF1	Focal adhesion
IGF1	Oocyte meiosis
TACC3	RNA transport
DCK	Purine metabolism
DCK	Pyrimidine metabolism
FN1	Regulation of actin cytoskeleton
FN1	Focal adhesion
ITGA4	Regulation of actin cytoskeleton
ITGA4	Focal adhesion
PPP2R2B	mRNA surveillance pathway
PPP2R2B	Tight junction
PTGDS	Arachidonic acid metabolism
SULT1A3	Sulfur metabolism
CBS	Cysteine and methionine metabolism
CBS	Glycine, serine and threonine metabolism
EIF4E	RNA transport
TLR2	Phagosome
LAMB2	Focal adhesion
ASL	Alanine, aspartate and glutamate metabolism
ASL	Arginine and proline metabolism
BAX	p53 signaling pathway
BAX	Apoptosis
BAX	Protein processing in endoplasmic reticulum
EP300	Adherens junction
EP300	Cell cycle
SLC9A1	Regulation of actin cytoskeleton
GPX1	Glutathione metabolism
GPX1	Arachidonic acid metabolism
PLCZ1	Inositol phosphate metabolism
PLCZ1	Oocyte meiosis
NOS3	Arginine and proline metabolism
PLCG2	Inositol phosphate metabolism
CCND1	Cell cycle
CCND1	p53 signaling pathway
CCND1	Focal adhesion
COL4A5	Focal adhesion
GSTM1	Glutathione metabolism
GSTM1	Metabolism of xenobiotics by cytochrome P450
GSTM1	Drug metabolism - cytochrome P450
OLR1	Phagosome
DHFR	Folate biosynthesis
DHFR	One carbon pool by folate
CDC25B	Cell cycle
EZR	Regulation of actin cytoskeleton
VEGFA	Focal adhesion
RDX	Regulation of actin cytoskeleton
XIAP	Ubiquitin mediated proteolysis
XIAP	Focal adhesion
XIAP	Apoptosis
DUT	Pyrimidine metabolism
PML	Endocytosis
PML	Ubiquitin mediated proteolysis
CXCR4	Endocytosis
NUDT2	Purine metabolism
NUDT2	Pyrimidine metabolism
CDKN1A	Cell cycle
CDKN1A	p53 signaling pathway
ACACB	Propanoate metabolism
ACACB	Pyruvate metabolism
ACACB	Fatty acid biosynthesis
CTSB	Lysosome
BLVRA	Porphyrin and chlorophyll metabolism
GGPS1	Terpenoid backbone biosynthesis
OGG1	Base excision repair
PTGS2	Arachidonic acid metabolism
SOCS3	Ubiquitin mediated proteolysis
ITGA5	Regulation of actin cytoskeleton
ITGA5	Phagosome
ITGA5	Focal adhesion
FCGR3B	Phagosome
LDLR	Endocytosis
ADRB2	Endocytosis
GSTO1	Glutathione metabolism
GSTO1	Metabolism of xenobiotics by cytochrome P450
GSTO1	Drug metabolism - cytochrome P450
PGD	Glutathione metabolism
PGD	Pentose phosphate pathway
HMGB1	Base excision repair
ITGB1	Regulation of actin cytoskeleton
ITGB1	Phagosome
ITGB1	Focal adhesion
EHD1	Endocytosis
SPP1	Focal adhesion
TP73	p53 signaling pathway
SKP2	Ubiquitin mediated proteolysis
SKP2	Cell cycle
COL4A1	Focal adhesion
MARCO	Phagosome
TAZ	Glycerophospholipid metabolism
HLA-DRB5	Phagosome
DDIT3	Protein processing in endoplasmic reticulum
CDKN1B	Cell cycle
FGF2	Regulation of actin cytoskeleton
CASP10	Apoptosis
MRC1	Phagosome
ITPKA	Inositol phosphate metabolism
ITPR1	Oocyte meiosis
ITPR1	Gap junction
SH3GLB1	Endocytosis
ITPR2	Oocyte meiosis
ITPR2	Gap junction
ITPK1	Inositol phosphate metabolism
ITPR3	Oocyte meiosis
ITPR3	Gap junction
RPS10	Ribosome
RPL15	Ribosome
CYP1B1	Tryptophan metabolism
CYP1B1	Steroid hormone biosynthesis
CYP1B1	Metabolism of xenobiotics by cytochrome P450
CYP17A1	Steroid hormone biosynthesis
NDUFC2	Oxidative phosphorylation
POP1	RNA transport
POP1	Ribosome biogenesis in eukaryotes
MYH6	Tight junction
CYP11B1	Steroid hormone biosynthesis
ALOX5	Arachidonic acid metabolism
CD36	Phagosome
MCM3	Cell cycle
MCM3	DNA replication
DAD1	N-Glycan biosynthesis
DAD1	Protein processing in endoplasmic reticulum
RPL13	Ribosome
ITPKB	Inositol phosphate metabolism
RPL27	Ribosome
HLA-G	Endocytosis
HLA-G	Phagosome
NEU1	Other glycan degradation
NEU1	Sphingolipid metabolism
NEU1	Lysosome
FADS2	Biosynthesis of unsaturated fatty acids
FADS2	alpha-Linolenic acid metabolism
NOS1	Phagosome
NOS1	Arginine and proline metabolism
MYD88	Apoptosis
HNMT	Histidine metabolism
CXCR2	Endocytosis
IL2RA	Endocytosis
ENPP2	Ether lipid metabolism
TFRC	Endocytosis
TFRC	Phagosome
CYBB	Phagosome
AHCYL1	Cysteine and methionine metabolism
RAD51	Homologous recombination
HLA-C	Endocytosis
HLA-C	Phagosome
CD14	Regulation of actin cytoskeleton
CD14	Phagosome
HLA-B	Endocytosis
HLA-B	Phagosome
PGR	Oocyte meiosis
AIRE	Ubiquitin mediated proteolysis
IDH1	Glutathione metabolism
IDH1	Citrate cycle (TCA cycle)
IDH1	Peroxisome
NFE2L2	Protein processing in endoplasmic reticulum
CYP11B2	Steroid hormone biosynthesis
ITGB2	Regulation of actin cytoskeleton
ITGB2	Phagosome
MSMO1	Steroid biosynthesis
SUMO1	RNA transport
CCNA2	Cell cycle
IL1B	Apoptosis
CDH1	Adherens junction
ADCY3	Purine metabolism
ADCY3	Oocyte meiosis
ADCY3	Gap junction
TGFB1	Endocytosis
TGFB1	Cell cycle
FGF3	Regulation of actin cytoskeleton
VAV1	Regulation of actin cytoskeleton
VAV1	Focal adhesion
TLR4	Phagosome
E2F1	Cell cycle
E2F3	Cell cycle
NGF	Apoptosis
CAV1	Endocytosis
CAV1	Focal adhesion
MVK	Peroxisome
MVK	Terpenoid backbone biosynthesis
IFNG	Proteasome
IFNG	Regulation of autophagy
MSR1	Phagosome
TNF	Apoptosis
BCAR1	Regulation of actin cytoskeleton
BCAR1	Focal adhesion
CBLB	Endocytosis
CBLB	Ubiquitin mediated proteolysis
HMOX1	Porphyrin and chlorophyll metabolism
CDC27	Ubiquitin mediated proteolysis
CDC27	Cell cycle
CDC27	Oocyte meiosis
ARRB2	Endocytosis
PCK1	Pyruvate metabolism
PCK1	Glycolysis / Gluconeogenesis
PCK1	Citrate cycle (TCA cycle)
SFTPA1	Phagosome
CRK	Regulation of actin cytoskeleton
CRK	Focal adhesion
PLD1	Endocytosis
PLD1	Glycerophospholipid metabolism
PLD1	Ether lipid metabolism
SMN1	RNA transport
SOD1	Peroxisome
NBN	Homologous recombination
FCGR1A	Phagosome
BCL2	Focal adhesion
BCL2	Apoptosis
BCL2	Protein processing in endoplasmic reticulum
CASP9	p53 signaling pathway
CASP9	Apoptosis
C3	Phagosome
TNC	Focal adhesion
ITGAL	Regulation of actin cytoskeleton
PDGFB	Regulation of actin cytoskeleton
PDGFB	Focal adhesion
PDGFB	Gap junction
CTTN	Tight junction
SGPP1	Sphingolipid metabolism
SERPINE1	p53 signaling pathway
FASLG	Apoptosis
MUTYH	Base excision repair
GSTP1	Glutathione metabolism
GSTP1	Metabolism of xenobiotics by cytochrome P450
GSTP1	Drug metabolism - cytochrome P450
ARSB	Glycosaminoglycan degradation
ARSB	Lysosome
CD68	Lysosome
NAT2	Caffeine metabolism
NAT2	Drug metabolism - other enzymes
IL3	Apoptosis
MYH11	Tight junction
ITGAX	Regulation of actin cytoskeleton
THBS1	Phagosome
THBS1	p53 signaling pathway
THBS1	Focal adhesion
FLT1	Endocytosis
FLT1	Focal adhesion
FAS	p53 signaling pathway
FAS	Apoptosis
MAD2L2	Cell cycle
MAD2L2	Oocyte meiosis
ALOX12	Arachidonic acid metabolism
CLTA	Endocytosis
CLTA	Lysosome
CTNNB1	Adherens junction
CTNNB1	Tight junction
CTNNB1	Focal adhesion
TP53	Cell cycle
TP53	p53 signaling pathway
TP53	Apoptosis
CCNB1	Cell cycle
CCNB1	p53 signaling pathway
CCNB1	Oocyte meiosis
MRE11A	Non-homologous end-joining
MRE11A	Homologous recombination
TRDMT1	Cysteine and methionine metabolism
SFTPD	Phagosome
GRM5	Gap junction
BECN1	Regulation of autophagy
EPRS	Porphyrin and chlorophyll metabolism
EPRS	Aminoacyl-tRNA biosynthesis
FCGR3A	Phagosome
MIF	Phenylalanine metabolism
MIF	Tyrosine metabolism
HGF	Focal adhesion
PTTG1	Cell cycle
PTTG1	Oocyte meiosis
GAPDH	Glycolysis / Gluconeogenesis
POLR2A	RNA polymerase
POLR2A	Purine metabolism
POLR2A	Pyrimidine metabolism
VTN	Focal adhesion
VAPA	Tight junction
SAT1	Arginine and proline metabolism
FGF5	Regulation of actin cytoskeleton
RAD50	Non-homologous end-joining
RAD50	Homologous recombination
GLO1	Pyruvate metabolism
PPA1	Oxidative phosphorylation
BAIAP2	Regulation of actin cytoskeleton
BAIAP2	Adherens junction
IFNA1	Regulation of autophagy
CAPN2	Focal adhesion
CAPN2	Apoptosis
CAPN2	Protein processing in endoplasmic reticulum
MTHFR	One carbon pool by folate
HLA-DQA1	Phagosome
TMSB4X	Regulation of actin cytoskeleton
LAMC1	Focal adhesion
SOS2	Regulation of actin cytoskeleton
SOS2	Focal adhesion
SOS2	Gap junction
TNFRSF1A	Apoptosis
CASP3	p53 signaling pathway
CASP3	Apoptosis
SOCS1	Ubiquitin mediated proteolysis
ANAPC10	Ubiquitin mediated proteolysis
ANAPC10	Cell cycle
ANAPC10	Oocyte meiosis
RELA	Apoptosis
KL	Pentose and glucuronate interconversions
KL	Starch and sucrose metabolism
CCNE1	Cell cycle
CCNE1	p53 signaling pathway
CCNE1	Oocyte meiosis
COL1A1	Focal adhesion
FGF23	Regulation of actin cytoskeleton
SETMAR	Lysine degradation
LYPLA2	Glycerophospholipid metabolism
CYP2D6	Drug metabolism - cytochrome P450
GPX3	Glutathione metabolism
GPX3	Arachidonic acid metabolism
HLA-A	Endocytosis
HLA-A	Phagosome
FAR1	Peroxisome
FAR2	Peroxisome
POLR1D	RNA polymerase
POLR1D	Purine metabolism
POLR1D	Pyrimidine metabolism
MGST3	Glutathione metabolism
MGST3	Metabolism of xenobiotics by cytochrome P450
MGST3	Drug metabolism - cytochrome P450
TRAF6	Endocytosis
TRAF6	Ubiquitin mediated proteolysis
TAF10	Basal transcription factors
NSFL1C	Protein processing in endoplasmic reticulum
SNAP23	SNARE interactions in vesicular transport
PGF	Focal adhesion
ORC5	Cell cycle
ORC1	Cell cycle
ORC2	Cell cycle
ORC3	Cell cycle
ORC4	Cell cycle
TSG101	Endocytosis
CTSD	Lysosome
FUT8	Glycosaminoglycan biosynthesis - keratan sulfate
FUT8	N-Glycan biosynthesis
AKR1C1	Steroid hormone biosynthesis
AKR1C1	Metabolism of xenobiotics by cytochrome P450
CAV2	Endocytosis
CAV2	Focal adhesion
TAF6L	Basal transcription factors
B3GAT3	Glycosaminoglycan biosynthesis - chondroitin sulfate
B3GAT3	Glycosaminoglycan biosynthesis - heparan sulfate
SMAD4	Adherens junction
SMAD4	Cell cycle
AKR1C4	Steroid hormone biosynthesis
AKR1C4	Metabolism of xenobiotics by cytochrome P450
AKR1C4	Primary bile acid biosynthesis
TPO	Tyrosine metabolism
FAU	Ribosome
ZBTB17	Cell cycle
HLA-DRB1	Phagosome
BET1L	SNARE interactions in vesicular transport
FGF14	Regulation of actin cytoskeleton
TP53I3	p53 signaling pathway
CCNB2	Cell cycle
CCNB2	p53 signaling pathway
CCNB2	Oocyte meiosis
PRDX5	Peroxisome
ND1	Oxidative phosphorylation
ND2	Oxidative phosphorylation
COX1	Oxidative phosphorylation
COX2	Oxidative phosphorylation
ATP8	Oxidative phosphorylation
ATP6	Oxidative phosphorylation
COX3	Oxidative phosphorylation
ND3	Oxidative phosphorylation
ND4L	Oxidative phosphorylation
ND4	Oxidative phosphorylation
ND5	Oxidative phosphorylation
ND6	Oxidative phosphorylation
CYTB	Oxidative phosphorylation
